DEPARTAMENTO,MUNICIPIO,CODIGO MUNICIPIO,TERNERAS < 1 AÑO,TERNEROS < 1 AÑO,HEMBRAS 1 - 2 AÑOS,MACHOS 1 - 2 AÑOS,HEMBRAS 2 - 3 AÑOS,MACHOS 2 - 3 AÑOS,HEMBRAS > 3 AÑOS,MACHOS > 3 AÑOS,TOTAL BOVINOS, No DE FINCAS 1 A 50, No DE FINCAS 51 A 100, No DE FINCAS 101 A 500, No DE FINCAS 501 O MAS,TOTAL FINCAS CON BOVINOS
ANTIOQUIA,MEDELLIN,5001,2270,765,2551,1157,1818,500,3773,100,12934,525,30,27,1,583
ANTIOQUIA,ABEJORRAL,5002,2820,1761,4145,2692,2600,1260,8717,777,24772,958,75,30,0,1063
ANTIOQUIA,ABRIAQUI,5004,1130,841,1178,1259,1166,531,3043,103,9251,249,37,12,0,298
ANTIOQUIA,ALEJANDRIA,5021,345,323,649,224,670,118,1302,146,3777,206,12,3,0,221
ANTIOQUIA,AMAGA,5030,383,297,803,1026,368,444,944,90,4355,193,6,10,0,209
ANTIOQUIA,AMALFI,5031,4082,4031,4097,5201,4771,4654,10958,1207,39001,635,127,83,4,849
ANTIOQUIA,ANDES,5034,506,482,932,821,972,648,1402,150,5913,231,16,10,0,257
ANTIOQUIA,ANGELOPOLIS,5036,204,125,492,609,312,560,420,149,2871,87,9,6,0,102
ANTIOQUIA,ANGOSTURA,5038,1937,697,2309,674,2086,665,5344,242,13954,444,41,20,0,505
ANTIOQUIA,ANORI,5040,5264,4959,4344,5489,4024,2637,11949,1006,39672,613,166,82,1,862
ANTIOQUIA,SANTA FE DE ANTIOQUIA,5042,2176,2006,2235,1559,2288,702,5664,547,17177,577,53,26,0,656
ANTIOQUIA,ANZA,5044,869,820,1402,1016,1241,1237,2348,221,9154,224,23,13,1,261
ANTIOQUIA,APARTADO,5045,2908,2340,2491,1668,2109,1097,6847,412,19872,341,51,42,4,438
ANTIOQUIA,ARBOLETES,5051,6820,6652,8513,13578,6419,9292,19325,3595,74194,627,121,121,30,899
ANTIOQUIA,ARGELIA,5055,1429,1246,1484,1061,1717,570,3851,323,11681,407,42,15,0,464
ANTIOQUIA,ARMENIA,5059,615,563,1548,2060,1579,1922,1540,1081,10908,67,10,28,4,109
ANTIOQUIA,BARBOSA,5079,2312,1561,2640,1937,2225,1236,3587,344,15842,709,56,16,1,782
ANTIOQUIA,BELMIRA,5086,6693,425,5871,474,6674,395,15703,181,36416,469,121,97,1,688
ANTIOQUIA,BELLO,5088,3563,345,2913,518,3473,246,8024,61,19143,302,87,44,0,433
ANTIOQUIA,BETANIA,5091,256,174,537,267,569,272,403,54,2532,53,7,7,0,67
ANTIOQUIA,BETULIA,5093,543,581,1174,1682,1092,1040,1552,364,8028,94,26,20,1,141
ANTIOQUIA,CIUDAD BOLIVAR,5101,513,465,1236,1504,1081,1388,1358,109,7654,168,25,21,0,214
ANTIOQUIA,BRICEÑO,5107,1774,1751,2169,2204,2168,3101,5872,516,19555,385,89,30,0,504
ANTIOQUIA,BURITICA,5113,619,670,1010,470,557,224,1872,252,5674,167,18,12,0,197
ANTIOQUIA,CACERES,5120,11050,9734,10016,6729,9542,5938,30613,2414,86036,283,61,100,49,493
ANTIOQUIA,CAICEDO,5125,449,510,507,1145,483,587,1129,189,4999,292,16,0,0,308
ANTIOQUIA,CALDAS,5129,364,229,707,444,212,130,1073,69,3228,140,11,3,0,154
ANTIOQUIA,CAMPAMENTO,5134,510,489,1386,1073,1269,999,3386,332,9444,332,35,8,0,375
ANTIOQUIA,CAÑASGORDAS,5138,1806,1604,2550,1833,1838,686,5086,402,15805,801,47,7,0,855
ANTIOQUIA,CARACOLI,5142,3225,2897,3398,1224,3533,377,8396,243,23293,157,64,70,2,293
ANTIOQUIA,CARAMANTA,5145,368,355,508,597,762,1056,930,295,4871,131,10,8,1,150
ANTIOQUIA,CAREPA,5147,3029,2902,3389,3177,2581,1746,9907,487,27218,280,75,72,4,431
ANTIOQUIA,EL CARMEN DE VIBORAL,5148,2560,652,2884,944,2274,454,6054,284,16106,930,46,16,0,992
ANTIOQUIA,CAROLINA,5150,581,210,703,846,583,424,1866,28,5241,150,13,10,0,173
ANTIOQUIA,CAUCASIA,5154,15472,14455,18018,10983,15665,7006,46031,4256,131886,358,86,197,73,714
ANTIOQUIA,CHIGORODO,5172,4813,4726,4198,6589,3287,7818,14438,876,46745,234,57,79,19,389
ANTIOQUIA,CISNEROS,5190,243,180,350,161,273,41,698,49,1995,113,8,1,0,122
ANTIOQUIA,COCORNA,5197,1429,1317,2091,936,1979,522,3274,487,12035,682,23,14,0,719
ANTIOQUIA,CONCEPCION,5206,962,696,1211,543,1420,400,2356,250,7838,421,19,5,0,445
ANTIOQUIA,CONCORDIA,5209,725,1232,1161,1721,1191,1813,2474,1012,11329,74,19,27,3,123
ANTIOQUIA,COPACABANA,5212,544,416,600,651,582,352,1130,74,4349,295,9,6,0,310
ANTIOQUIA,DABEIBA,5234,3625,3475,3774,3868,3304,2498,10203,828,31575,656,136,48,3,843
ANTIOQUIA,DONMATIAS,5237,7501,951,5830,1238,5341,730,14245,241,36077,412,163,90,0,665
ANTIOQUIA,EBEJICO,5240,824,1210,1286,4164,870,5007,1948,2049,17358,366,23,22,8,419
ANTIOQUIA,EL BAGRE,5250,3094,3286,2962,1724,3287,678,10195,590,25816,243,79,61,4,387
ANTIOQUIA,ENTRERRIOS,5264,9823,372,8377,400,9485,318,28859,227,57861,312,244,174,5,735
ANTIOQUIA,ENVIGADO,5266,430,180,429,201,259,79,613,21,2212,143,6,3,0,152
ANTIOQUIA,FREDONIA,5282,2192,1785,3243,2815,3418,4616,6089,404,24562,414,41,56,6,517
ANTIOQUIA,FRONTINO,5284,3483,3015,3412,2944,3554,2197,10152,609,29366,652,108,52,0,812
ANTIOQUIA,GIRALDO,5306,150,178,293,223,316,61,619,58,1898,95,5,1,0,101
ANTIOQUIA,GIRARDOTA,5308,1305,812,1242,880,1209,819,2492,271,9030,372,26,22,0,420
ANTIOQUIA,GOMEZ PLATA,5310,1535,1290,1804,3744,2450,3077,3865,821,18586,300,55,36,3,394
ANTIOQUIA,GRANADA,5313,910,731,1833,579,1347,438,5189,254,11281,908,17,6,0,931
ANTIOQUIA,GUADALUPE,5315,710,865,696,1902,734,1297,1603,408,8215,270,31,9,0,310
ANTIOQUIA,GUARNE,5318,925,421,1263,656,738,199,2002,77,6281,648,18,2,0,668
ANTIOQUIA,GUATAPE,5321,150,112,246,150,292,125,800,104,1979,126,6,0,0,132
ANTIOQUIA,HELICONIA,5347,501,575,896,2019,632,1752,1118,748,8241,135,11,18,1,165
ANTIOQUIA,HISPANIA,5353,683,637,832,557,1058,448,1586,139,5940,67,12,15,1,95
ANTIOQUIA,ITAGÜI,5360,70,48,63,43,66,48,76,1,415,22,1,0,0,23
ANTIOQUIA,ITUANGO,5361,4997,4592,4893,6546,5374,7479,10115,1811,45807,787,152,112,1,1052
ANTIOQUIA,JARDIN,5364,511,552,622,753,604,575,1225,195,5037,216,23,3,0,242
ANTIOQUIA,JERICO,5368,1240,1097,1786,2442,1995,2340,3126,400,14426,308,28,37,2,375
ANTIOQUIA,LA CEJA,5376,2069,592,3291,727,1920,420,3713,166,12898,461,46,19,0,526
ANTIOQUIA,LA ESTRELLA,5380,122,86,235,190,91,30,191,60,1005,84,2,1,0,87
ANTIOQUIA,LA PINTADA,5390,279,220,821,1832,961,1447,939,136,6635,32,5,19,1,57
ANTIOQUIA,LA UNION,5400,3565,363,4150,531,2624,420,11393,101,23147,806,84,28,0,918
ANTIOQUIA,LIBORINA,5411,1011,976,1268,1345,527,433,2231,183,7974,394,32,6,0,432
ANTIOQUIA,MACEO,5425,4312,4131,4562,8168,3904,7471,13597,1992,48137,309,71,102,17,499
ANTIOQUIA,MARINILLA,5440,1649,933,2813,1078,2387,536,2445,130,11971,911,37,12,0,960
ANTIOQUIA,MONTEBELLO,5467,242,200,386,325,203,255,432,81,2124,137,4,1,0,142
ANTIOQUIA,MURINDO,5475,0,0,15,10,8,82,254,27,396,98,64,0,0,162
ANTIOQUIA,MUTATA,5480,8362,8126,7219,10375,5961,8747,26119,2447,77356,298,109,169,30,606
ANTIOQUIA,NARIÑO,5483,1355,1344,1637,1291,1669,765,4107,432,12600,765,28,9,0,802
ANTIOQUIA,NECOCLI,5490,13517,11648,13642,8343,10944,4761,42335,2145,107335,1085,185,196,35,1501
ANTIOQUIA,NECHI,5495,3769,4279,4000,3063,3296,4811,12814,1243,37275,291,94,61,12,458
ANTIOQUIA,OLAYA,5501,378,444,653,675,432,441,923,129,4075,141,8,7,0,156
ANTIOQUIA,PEÑOL,5541,845,735,1058,350,878,251,2318,307,6742,719,7,1,0,727
ANTIOQUIA,PEQUE,5543,781,695,996,719,1135,496,2178,200,7200,370,13,4,0,387
ANTIOQUIA,PUEBLORRICO,5576,328,273,516,481,743,215,936,80,3572,187,5,9,0,201
ANTIOQUIA,PUERTO BERRIO,5579,10051,9461,11364,18393,9251,18878,29121,4387,110906,161,72,149,69,451
ANTIOQUIA,PUERTO NARE,5585,5641,5077,6539,7370,5010,6532,14685,2392,53246,198,82,101,23,404
ANTIOQUIA,PUERTO TRIUNFO,5591,3907,3908,5138,6361,5629,7840,12074,2721,47578,81,53,81,27,242
ANTIOQUIA,REMEDIOS,5604,20180,19519,18217,16758,18285,13143,52005,6545,164652,301,304,445,48,1098
ANTIOQUIA,RETIRO,5607,853,263,994,227,940,119,808,45,4249,293,7,5,0,305
ANTIOQUIA,RIONEGRO,5615,2856,1198,3469,1074,2482,380,3923,314,15696,934,39,19,1,993
ANTIOQUIA,SABANALARGA,5628,483,410,461,333,489,327,947,107,3557,222,6,1,0,229
ANTIOQUIA,SABANETA,5631,84,64,90,53,46,13,63,5,418,30,0,0,0,30
ANTIOQUIA,SALGAR,5642,442,377,970,1841,843,887,1338,113,6811,199,10,17,0,226
ANTIOQUIA,SAN ANDRES DE CUERQUIA,5647,1850,498,2247,793,2240,649,3192,229,11698,265,45,19,1,330
ANTIOQUIA,SAN CARLOS,5649,3561,3506,4302,1992,5026,824,9758,953,29922,696,88,65,1,850
ANTIOQUIA,SAN FRANCISCO,5652,723,620,972,548,997,169,2050,161,6240,228,17,10,0,255
ANTIOQUIA,SAN JERONIMO,5656,1057,674,1272,823,907,376,1816,149,7074,376,25,7,0,408
ANTIOQUIA,SAN JOSE DE LA MONTAÑA,5658,3413,221,2900,307,2875,344,5600,138,15798,93,77,42,1,213
ANTIOQUIA,SAN JUAN DE URABA,5659,2244,1897,1262,2049,1195,2389,6089,277,17402,146,23,20,6,195
ANTIOQUIA,SAN LUIS,5660,2214,2140,2977,2290,3051,1539,6279,818,21308,310,62,53,1,426
ANTIOQUIA,SAN PEDRO DE LOS MILAGROS,5664,14639,964,12675,733,14973,451,34417,146,78998,1187,304,184,3,1678
ANTIOQUIA,SAN PEDRO DE URABA,5665,7828,7216,8556,8520,10818,5969,22764,2132,73803,744,180,142,18,1084
ANTIOQUIA,SAN RAFAEL,5667,1435,1471,1819,720,2058,467,4555,394,12919,618,28,16,0,662
ANTIOQUIA,SAN ROQUE,5670,2209,2108,2757,2836,3198,1870,6570,1109,22657,467,59,48,3,577
ANTIOQUIA,SAN VICENTE FERRER,5674,1138,974,1518,1118,749,410,3053,254,9214,1216,8,1,0,1225
ANTIOQUIA,SANTA BARBARA,5679,1105,1040,2574,2710,1926,1600,2796,496,14247,318,22,36,2,378
ANTIOQUIA,SANTA ROSA DE OSOS,5686,29975,2966,27545,2930,32907,2077,66450,931,165781,1463,657,469,11,2600
ANTIOQUIA,SANTO DOMINGO,5690,2028,1718,2642,1495,2471,794,5165,476,16789,575,56,22,0,653
ANTIOQUIA,EL SANTUARIO,5697,1656,980,2147,719,2436,330,3273,242,11783,922,29,11,0,962
ANTIOQUIA,SEGOVIA,5736,5699,4969,6270,4742,6719,3468,19064,3129,54060,130,121,167,11,429
ANTIOQUIA,SONSON,5756,6306,5649,6821,6584,7187,7378,20415,2130,62470,1118,124,89,23,1354
ANTIOQUIA,SOPETRAN,5761,1664,1200,1536,1222,1826,892,3370,284,11994,352,45,21,0,418
ANTIOQUIA,TAMESIS,5789,1147,1123,2067,2530,1470,2481,2818,502,14138,357,43,26,2,428
ANTIOQUIA,TARAZA,5790,5147,4447,5383,3333,5229,1833,14909,919,41200,242,88,73,15,418
ANTIOQUIA,TARSO,5792,620,440,1792,1816,2800,1814,1478,111,10871,123,15,32,1,171
ANTIOQUIA,TITIRIBI,5809,844,637,1547,2295,1582,1844,2203,398,11350,139,22,28,3,192
ANTIOQUIA,TOLEDO,5819,654,386,472,208,584,299,1054,229,3886,114,11,7,0,132
ANTIOQUIA,TURBO,5837,21316,19624,21238,18554,16140,13383,61760,3848,175863,1202,346,377,55,1980
ANTIOQUIA,URAMITA,5842,1531,1351,1341,1203,1308,915,3595,298,11542,336,34,18,0,388
ANTIOQUIA,URRAO,5847,2608,2796,2473,3305,2938,5704,7699,1580,29103,586,112,58,0,756
ANTIOQUIA,VALDIVIA,5854,3131,2617,4007,2971,4228,2088,8826,701,28569,408,126,56,0,590
ANTIOQUIA,VALPARAISO,5856,442,838,681,2291,712,4006,1145,906,11021,106,23,26,4,159
ANTIOQUIA,VEGACHI,5858,4065,4046,3963,2893,3682,2037,10679,1084,32449,178,93,96,2,369
ANTIOQUIA,VENECIA,5861,640,993,1806,2598,1514,2329,1689,124,11693,153,10,32,3,198
ANTIOQUIA,VIGIA DEL FUERTE,5873,0,0,0,0,74,109,146,38,367,112,83,0,0,195
ANTIOQUIA,YALI,5885,4036,4014,3249,2198,3514,1321,10510,708,29550,172,76,80,6,334
ANTIOQUIA,YARUMAL,5887,11016,2334,10220,2961,9079,2423,22876,1094,62003,711,272,143,2,1128
ANTIOQUIA,YOLOMBO,5890,5077,4622,5666,5594,5698,3664,13815,1204,45340,505,117,104,6,732
ANTIOQUIA,YONDO,5893,11741,13410,11946,24480,12457,25229,32641,4242,136146,470,192,223,57,942
ANTIOQUIA,ZARAGOZA,5895,3760,3280,3214,1594,3641,445,10330,380,26644,151,54,79,5,289
ATLANTICO,BARRANQUILLA,8001,135,141,232,208,252,128,332,23,1451,17,5,3,0,25
ATLANTICO,BARANOA,8078,1676,1708,1799,1478,1615,727,4562,356,13921,179,33,32,3,247
ATLANTICO,CAMPO DE LA CRUZ,8137,2315,2648,1332,1268,1733,205,8798,420,18719,480,58,29,0,567
ATLANTICO,CANDELARIA,8141,2453,2979,1517,1416,3278,432,8325,377,20777,322,69,45,1,437
ATLANTICO,GALAPA,8296,541,437,462,383,724,127,1047,87,3808,77,10,10,0,97
ATLANTICO,JUAN DE ACOSTA,8372,1322,1209,954,528,1292,292,3619,268,9484,248,46,9,0,303
ATLANTICO,LURUACO,8421,1676,1723,2000,3132,1116,1446,4650,488,16231,224,27,39,3,293
ATLANTICO,MALAMBO,8433,783,837,776,1112,567,249,1480,137,5941,58,14,12,2,86
ATLANTICO,MANATI,8436,3202,4523,2669,3018,2707,824,10400,612,27955,592,80,49,0,721
ATLANTICO,PALMAR DE VARELA,8520,671,704,436,357,523,231,1964,105,4991,92,11,14,1,118
ATLANTICO,PIOJO,8549,1437,1479,1249,1262,1263,552,4149,283,11674,189,23,20,4,236
ATLANTICO,POLONUEVO,8558,958,814,630,356,745,197,2733,202,6635,117,13,14,2,146
ATLANTICO,PONEDERA,8560,2221,2104,1693,1325,1776,699,6485,404,16707,234,32,47,1,314
ATLANTICO,PUERTO COLOMBIA,8573,7,14,5,0,32,0,25,1,84,3,1,0,0,4
ATLANTICO,REPELON,8606,1169,1550,897,1790,1052,522,4222,237,11439,363,27,16,1,407
ATLANTICO,SABANAGRANDE,8634,591,499,399,202,680,364,1678,76,4489,63,9,11,1,84
ATLANTICO,SABANALARGA,8638,5680,5544,4183,4971,4503,2125,17389,1475,45870,647,93,104,10,854
ATLANTICO,SANTA LUCIA,8675,1335,1480,1087,901,1471,134,4053,214,10675,343,28,12,1,384
ATLANTICO,SANTO TOMAS,8685,766,804,691,829,478,205,2563,154,6490,144,14,14,1,173
ATLANTICO,SOLEDAD,8758,380,320,293,127,376,45,646,59,2246,26,4,8,0,38
ATLANTICO,SUAN,8770,835,760,827,162,360,63,2179,119,5305,150,17,5,1,173
ATLANTICO,TUBARA,8832,433,446,384,462,419,75,1457,75,3751,87,9,10,0,106
ATLANTICO,USIACURI,8849,798,803,907,599,1053,334,2737,149,7380,106,10,17,1,134
BOGOTA D.C.,BOGOTA D.C.,11001,5441,4156,4602,4178,4062,1729,11689,498,36355,1756,105,30,0,1891
BOLIVAR,CARTAGENA DE INDIAS,13001,1242,1608,1550,9462,1670,6812,3733,1075,27152,72,25,45,9,151
BOLIVAR,ACHI,13006,6824,7231,4976,5009,7509,1619,25752,1509,60429,502,188,134,11,835
BOLIVAR,ALTOS DEL ROSARIO,13030,2722,3053,1418,3522,1945,591,10674,502,24427,91,44,75,5,215
BOLIVAR,ARENAL,13042,2288,3086,1572,5880,2333,1195,8373,493,25220,163,58,67,5,293
BOLIVAR,ARJONA,13052,5771,6350,5288,8613,6284,5105,18714,2161,58286,358,106,144,15,623
BOLIVAR,ARROYOHONDO,13062,2635,2566,2338,1494,2588,722,7563,427,20333,139,50,63,2,254
BOLIVAR,BARRANCO DE LOBA,13074,3236,3241,2509,5524,2772,1303,9685,598,28868,90,61,58,14,223
BOLIVAR,CALAMAR,13140,3248,3353,2893,2827,3141,2821,9494,540,28317,169,81,68,6,324
BOLIVAR,CANTAGALLO,13160,1986,1993,2062,902,2133,327,5893,565,15861,318,61,29,0,408
BOLIVAR,CICUCO,13188,1570,2039,749,1755,934,377,5301,278,13003,53,20,26,5,104
BOLIVAR,CORDOBA,13212,5795,5960,4083,4794,5060,1625,14601,841,42759,216,108,118,7,449
BOLIVAR,CLEMENCIA,13222,763,925,1110,2293,352,992,2581,244,9260,75,21,16,1,113
BOLIVAR,EL CARMEN DE BOLIVAR,13244,5752,6503,5276,5093,5860,850,17145,1221,47700,1099,121,83,6,1309
BOLIVAR,EL GUAMO,13248,3353,3588,2989,3918,2924,666,9340,703,27481,310,70,69,4,453
BOLIVAR,EL PEÑON,13268,2439,2298,2174,3067,2706,533,7308,399,20924,120,39,31,8,198
BOLIVAR,HATILLO DE LOBA,13300,3094,3770,2365,4196,3037,1673,10444,780,29359,139,53,61,11,264
BOLIVAR,MAGANGUE,13430,16335,16925,16126,14238,12487,4753,47986,3097,131947,553,201,256,52,1062
BOLIVAR,MAHATES,13433,5951,5758,4367,7296,6450,2032,18174,1521,51549,620,123,111,8,862
BOLIVAR,MARGARITA,13440,4127,5419,3122,8744,4523,2425,13778,1679,43817,275,97,112,10,494
BOLIVAR,MARIA LA BAJA,13442,4884,4733,4697,3494,4318,946,13329,833,37234,351,145,87,4,587
BOLIVAR,MONTECRISTO,13458,1985,1798,1445,766,1638,419,5008,179,13238,230,51,16,2,299
BOLIVAR,MOMPOS,13468,6905,7352,5861,12726,7052,4632,22205,3032,69765,323,130,145,19,617
BOLIVAR,MORALES,13473,10007,11123,8141,17748,12324,9436,28231,2518,99528,503,235,269,23,1030
BOLIVAR,NOROSI,13490,1938,1889,1588,2485,2524,388,5416,334,16562,111,47,49,1,208
BOLIVAR,PINILLOS,13549,5615,4997,3517,5900,5265,601,16910,967,43772,327,105,111,8,551
BOLIVAR,REGIDOR,13580,1067,1140,750,2048,1635,702,3338,595,11275,80,22,25,3,130
BOLIVAR,RIO VIEJO,13600,2268,2480,1824,2650,2954,627,6817,489,20109,199,74,54,0,327
BOLIVAR,SAN CRISTOBAL,13620,857,1116,354,543,777,99,2534,159,6439,110,23,14,0,147
BOLIVAR,SAN ESTANISLAO,13647,2379,2684,1918,2701,2087,915,6716,390,19790,142,49,37,7,235
BOLIVAR,SAN FERNANDO,13650,2894,3556,2719,6878,2692,3452,10037,945,33173,221,51,51,15,338
BOLIVAR,SAN JACINTO,13654,2671,3033,2941,3711,3992,1423,8494,686,26951,546,83,44,2,675
BOLIVAR,SAN JACINTO DEL CAUCA,13655,1633,1492,1219,1417,2407,318,4657,243,13386,90,47,29,2,168
BOLIVAR,SAN JUAN NEPOMUCENO,13657,4563,4762,3629,7339,5591,2990,13626,948,43448,519,136,89,8,752
BOLIVAR,SAN MARTIN DE LOBA,13667,3218,3112,1945,2364,2689,491,9282,481,23582,182,92,60,2,336
BOLIVAR,SAN PABLO,13670,5845,5739,4652,3230,5380,1386,15692,976,42900,462,107,116,5,690
BOLIVAR,SANTA CATALINA,13673,1147,1979,859,6174,1365,3351,3469,820,19164,71,21,15,7,114
BOLIVAR,SANTA ROSA,13683,1055,1503,1672,6361,1767,4266,5236,2742,24602,70,13,29,11,123
BOLIVAR,SANTA ROSA DEL SUR,13688,5612,5705,5011,4765,7938,4587,16583,1938,52139,1059,201,98,0,1358
BOLIVAR,SIMITI,13744,9531,9802,7513,6064,12249,4442,27776,2201,79578,491,227,252,8,978
BOLIVAR,SOPLAVIENTO,13760,447,206,293,454,291,128,1068,72,2959,57,7,8,0,72
BOLIVAR,TALAIGUA NUEVO,13780,2193,2153,1672,1611,2130,560,5747,337,16403,191,35,39,2,267
BOLIVAR,TIQUISIO,13810,2052,2421,1462,2580,2747,313,8026,596,20197,132,52,48,5,237
BOLIVAR,TURBACO,13836,1272,1637,981,4915,1499,2268,3882,359,16813,114,33,21,4,172
BOLIVAR,TURBANA,13838,1808,1800,1589,1508,1826,1059,5168,310,15068,111,21,36,3,171
BOLIVAR,VILLANUEVA,13873,1437,1349,1305,1213,1398,372,4610,452,12136,136,30,23,4,193
BOLIVAR,ZAMBRANO,13894,1202,1248,987,1763,910,394,3220,160,9884,99,33,23,0,155
BOYACA,TUNJA,15001,1148,1292,1084,1150,764,681,3521,326,9966,782,19,6,0,807
BOYACA,ALMEIDA,15022,258,294,258,325,242,275,833,147,2632,333,1,1,0,335
BOYACA,AQUITANIA,15047,1911,2169,1947,2738,1832,2627,4926,1032,19182,1298,40,6,0,1344
BOYACA,ARCABUCO,15051,1175,882,827,800,821,563,3553,171,8792,552,15,4,0,571
BOYACA,BELEN,15087,1775,1049,1612,1001,1386,587,7052,157,14619,909,20,10,0,939
BOYACA,BERBEO,15090,419,529,403,345,464,461,1193,242,4056,253,8,2,0,263
BOYACA,BETEITIVA,15092,418,591,328,256,366,87,1162,29,3237,448,0,0,0,448
BOYACA,BOAVITA,15097,870,757,1069,968,778,612,2230,321,7605,838,3,1,0,842
BOYACA,BOYACA,15104,563,601,1009,953,936,395,1619,85,6161,844,6,1,0,851
BOYACA,BRICEÑO,15106,169,239,279,258,377,265,1076,89,2752,224,3,1,0,228
BOYACA,BUENAVISTA,15109,713,671,919,797,614,363,2191,161,6429,676,7,0,0,683
BOYACA,BUSBANZA,15114,93,108,85,102,67,25,200,0,680,93,0,0,0,93
BOYACA,CALDAS,15131,1209,408,1403,421,1285,234,6518,42,11520,933,12,3,0,948
BOYACA,CAMPOHERMOSO,15135,1842,2169,1827,1901,2163,1802,5323,1291,18318,617,73,11,0,701
BOYACA,CERINZA,15162,460,293,627,346,753,134,2411,26,5050,471,3,2,0,476
BOYACA,CHINAVITA,15172,560,655,819,1041,905,952,1858,399,7189,661,2,0,0,663
BOYACA,CHIQUINQUIRA,15176,4669,1074,4821,959,4647,580,17713,148,34611,1916,67,37,2,2022
BOYACA,CHISCAS,15180,1258,1488,1166,1158,1260,1543,4850,1223,13946,1020,11,1,0,1032
BOYACA,CHITA,15183,1014,1361,1488,1670,1310,1254,2755,575,11427,1157,12,0,0,1169
BOYACA,CHITARAQUE,15185,300,366,352,493,655,655,1086,355,4262,259,11,3,0,273
BOYACA,CHIVATA,15187,547,415,437,184,75,76,1237,12,2983,397,3,0,0,400
BOYACA,CIENEGA,15189,662,941,375,517,229,492,2430,70,5716,647,3,0,0,650
BOYACA,COMBITA,15204,2168,1685,1957,877,1720,316,5572,50,14345,1324,11,7,0,1342
BOYACA,MONIQUIRA,15469,1280,1372,1635,1546,1744,837,3624,417,12455,867,30,7,0,904
BOYACA,MOTAVITA,15476,1033,1158,675,581,401,235,3701,36,7820,789,10,0,0,799
BOYACA,MUZO,15480,670,628,759,920,669,1296,1860,431,7233,191,27,12,0,230
BOYACA,NOBSA,15491,308,197,345,118,296,27,773,10,2074,242,1,1,0,244
BOYACA,NUEVO COLON,15494,448,450,496,362,449,160,1200,35,3600,488,5,0,0,493
BOYACA,OICATA,15500,814,393,696,314,542,134,2577,35,5505,343,11,2,1,357
BOYACA,OTANCHE,15507,1834,1566,2312,1962,1673,1432,4696,751,16226,500,63,14,0,577
BOYACA,PACHAVITA,15511,559,566,650,824,577,649,1619,360,5804,671,3,0,0,674
BOYACA,PAEZ,15514,1885,2265,1811,1991,2164,2032,6718,1359,20225,591,70,26,0,687
BOYACA,PAIPA,15516,3044,2136,2862,1878,2395,998,8808,237,22358,1697,38,12,0,1747
BOYACA,PAJARITO,15518,778,787,863,1311,785,1382,1962,800,8668,194,34,17,0,245
BOYACA,PANQUEBA,15522,397,447,464,561,535,486,727,148,3765,308,1,0,0,309
BOYACA,PAUNA,15531,1005,830,1368,1090,1493,1043,3537,584,10950,622,31,9,0,662
BOYACA,PAYA,15533,982,1055,901,892,757,650,2866,364,8467,324,32,7,0,363
BOYACA,PAZ DE RIO,15537,313,341,317,417,312,238,717,57,2712,322,0,0,0,322
BOYACA,PESCA,15542,1259,1391,1412,969,780,888,7086,221,14006,974,16,0,0,990
BOYACA,PISBA,15550,462,492,583,635,622,447,1582,281,5104,273,19,2,0,294
BOYACA,PUERTO BOYACA,15572,13663,13800,17900,27725,15101,28630,35477,7431,159727,453,151,291,79,974
BOYACA,QUIPAMA,15580,605,541,726,749,489,690,1600,126,5526,251,11,7,0,269
BOYACA,RAMIRIQUI,15599,1213,1488,1063,968,769,741,4126,347,10715,1081,7,1,0,1089
BOYACA,RAQUIRA,15600,541,421,636,676,425,155,2128,32,5014,520,3,3,0,526
BOYACA,RONDON,15621,517,845,828,1217,893,1159,1941,221,7621,585,9,1,0,595
BOYACA,SABOYA,15632,3303,1915,3695,1724,2760,881,15373,97,29748,2778,35,7,0,2820
BOYACA,SACHICA,15638,52,109,80,180,45,43,21,4,534,130,0,0,0,130
BOYACA,SAMACA,15646,765,749,947,1229,529,493,2775,106,7593,859,17,0,0,876
BOYACA,SAN EDUARDO,15660,656,705,723,622,632,635,1725,333,6031,407,6,0,0,413
BOYACA,SAN JOSE DE PARE,15664,182,131,161,265,173,114,477,95,1598,174,2,0,0,176
BOYACA,SAN LUIS DE GACENO,15667,3947,3791,4069,4066,4160,4470,10121,2518,37142,471,163,86,1,721
BOYACA,SAN MATEO,15673,1043,1071,960,913,1049,714,1859,359,7968,716,9,0,0,725
BOYACA,SAN MIGUEL DE SEMA,15676,2915,345,2883,465,2243,241,13214,15,22321,849,44,43,2,938
BOYACA,SAN PABLO DE BORBUR,15681,817,799,973,1032,1051,863,2271,276,8082,339,15,10,0,364
BOYACA,SANTANA,15686,153,203,221,275,118,119,464,75,1628,124,1,4,0,129
BOYACA,SANTA MARIA,15690,1535,1425,1443,1488,1560,1372,3976,806,13605,404,52,12,0,468
BOYACA,SANTA ROSA DE VITERBO,15693,1231,830,1681,720,874,314,5154,47,10851,732,30,4,0,766
BOYACA,SANTA SOFIA,15696,399,426,682,726,550,471,1229,122,4605,450,5,1,0,456
BOYACA,SATIVANORTE,15720,668,637,754,708,612,397,1362,143,5281,528,6,1,0,535
BOYACA,SATIVASUR,15723,237,284,225,280,155,151,668,43,2043,237,2,0,0,239
BOYACA,SIACHOQUE,15740,1967,1989,1589,1822,635,571,5929,86,14588,1566,8,0,0,1574
BOYACA,SOATA,15753,432,416,473,600,528,361,1014,158,3982,493,1,0,0,494
BOYACA,SOCOTA,15755,884,1370,1082,1464,570,1215,2485,197,9267,1013,4,2,0,1019
BOYACA,SOCHA,15757,494,532,409,404,437,281,1151,70,3778,462,0,0,0,462
BOYACA,SOGAMOSO,15759,1583,2312,1458,1484,765,619,4558,64,12843,1554,4,1,0,1559
BOYACA,SOMONDOCO,15761,502,515,526,457,472,438,1485,168,4563,545,3,1,0,549
BOYACA,SORA,15762,357,457,313,233,176,116,1568,23,3243,352,1,0,0,353
BOYACA,SOTAQUIRA,15763,3084,1395,2433,1048,3120,550,8475,94,20199,947,52,23,1,1023
BOYACA,SORACA,15764,1296,1153,1021,718,697,158,2816,49,7908,1000,7,2,0,1009
BOYACA,SUSACON,15774,628,837,915,850,912,572,1933,101,6748,620,10,1,0,631
BOYACA,SUTAMARCHAN,15776,507,656,557,735,264,317,1493,30,4559,640,0,0,0,640
BOYACA,SUTATENZA,15778,362,366,567,379,418,258,1021,115,3486,605,0,0,0,605
BOYACA,TASCO,15790,989,1428,977,1103,585,608,3790,118,9598,713,17,1,0,731
BOYACA,TENZA,15798,511,596,590,787,648,631,1757,281,5801,707,2,0,0,709
BOYACA,TIBANA,15804,1240,1328,1263,1187,965,835,3597,254,10669,1352,1,2,0,1355
BOYACA,TIBASOSA,15806,1219,877,1181,532,793,176,3729,105,8612,781,21,4,0,806
BOYACA,TINJACA,15808,467,284,473,351,222,99,1149,6,3051,476,0,0,0,476
BOYACA,TIPACOQUE,15810,455,544,510,521,476,293,1690,275,4764,567,1,0,0,568
BOYACA,TOCA,15814,1372,1031,1938,993,1741,637,7297,223,15232,1342,16,4,0,1362
BOYACA,TOGÜI,15816,371,273,344,276,245,213,870,88,2680,205,2,3,0,210
BOYACA,TOPAGA,15820,142,196,133,92,66,86,782,43,1540,241,0,0,0,241
BOYACA,TOTA,15822,1367,1574,991,621,713,164,3806,1,9237,891,1,1,0,893
BOYACA,TUNUNGUA,15832,56,62,87,168,113,104,194,23,807,97,2,0,0,99
BOYACA,TURMEQUE,15835,1184,1736,1389,954,204,677,4631,44,10819,935,6,0,0,941
BOYACA,TUTA,15837,3036,2062,4098,2294,2720,829,13045,381,28465,1635,58,13,1,1707
BOYACA,TUTAZA,15839,878,1068,621,854,974,633,3010,42,8080,534,9,0,0,543
BOYACA,UMBITA,15842,1605,2384,1520,1112,1030,585,5643,58,13937,1293,5,1,0,1299
BOYACA,VENTAQUEMADA,15861,2527,2870,2581,1720,2093,787,10252,289,23119,1960,29,3,0,1992
BOYACA,VIRACACHA,15879,861,1167,511,667,396,245,2858,13,6718,666,6,0,0,672
BOYACA,ZETAQUIRA,15897,859,1432,1216,1289,1371,1202,2319,390,10078,642,21,4,0,667
CALDAS,MANIZALES,17001,2646,2010,3986,3079,3390,2939,6256,672,24978,404,58,68,4,534
CALDAS,AGUADAS,17013,1605,1721,2677,5994,3088,5130,3946,1995,26156,300,75,67,3,445
CALDAS,ANSERMA,17042,1289,1091,2179,953,2673,975,3094,327,12581,272,12,33,2,319
CALDAS,ARANZAZU,17050,863,854,1221,1556,895,679,2252,104,8424,312,28,16,0,356
CALDAS,BELALCAZAR,17088,411,327,1057,320,1356,615,1364,230,5680,69,13,19,0,101
CALDAS,CHINCHINA,17174,379,214,1280,300,1252,136,839,124,4524,89,12,10,1,112
CALDAS,FILADELFIA,17272,994,1082,3149,2653,2724,2583,2498,921,16604,217,41,36,4,298
CALDAS,LA DORADA,17380,5667,5544,6747,8194,5658,7998,16465,5314,61587,235,55,112,32,434
CALDAS,LA MERCED,17388,855,638,1392,1621,1742,1145,1819,152,9364,164,11,15,5,195
CALDAS,MANZANARES,17433,588,549,850,800,760,398,1534,133,5612,335,17,5,0,357
CALDAS,MARMATO,17442,131,153,340,689,341,128,458,75,2315,112,10,1,0,123
CALDAS,MARQUETALIA,17444,307,407,573,617,527,319,824,141,3715,295,13,0,0,308
CALDAS,MARULANDA,17446,2093,2278,2145,2493,1639,1586,4073,338,16645,126,59,44,2,231
CALDAS,NEIRA,17486,2824,2601,3562,4732,3795,4514,5462,1419,28909,408,61,53,9,531
CALDAS,NORCASIA,17495,1511,1363,1669,1624,1367,1010,4640,542,13726,174,43,34,1,252
CALDAS,PACORA,17513,1076,936,1611,1261,1729,1213,3029,749,11604,322,34,22,0,378
CALDAS,PALESTINA,17524,803,310,1856,537,1536,632,2300,117,8091,92,24,20,1,137
CALDAS,PENSILVANIA,17541,1488,1469,1958,1494,1802,781,3572,255,12819,606,37,11,0,654
CALDAS,RIOSUCIO,17614,1042,1283,1772,1710,1692,1230,3768,746,13243,548,41,11,1,601
CALDAS,RISARALDA,17616,629,447,808,357,1184,401,1571,84,5481,127,7,14,1,149
CALDAS,SALAMINA,17653,3336,3145,3441,2208,2878,912,7532,370,23822,340,68,82,1,491
CALDAS,SAMANA,17662,3821,3817,5600,5160,5623,2790,11054,1188,39053,1189,124,72,1,1386
CALDAS,SAN JOSE,17665,286,211,391,148,594,126,758,67,2581,60,6,8,0,74
CALDAS,SUPIA,17777,515,476,1228,1401,950,1356,1519,316,7761,361,18,14,0,393
CALDAS,VICTORIA,17867,4461,4088,5963,6296,5125,5439,13738,1809,46919,283,48,94,16,441
CALDAS,VILLAMARIA,17873,1710,1457,2097,1719,1743,1010,5021,395,15152,276,43,36,3,358
CALDAS,VITERBO,17877,1091,557,1977,377,2785,471,2368,162,9788,83,12,33,1,129
CAQUETA,FLORENCIA,18001,8507,8231,7596,6564,8360,5968,24610,3666,73502,857,203,156,11,1227
CAQUETA,ALBANIA,18029,4640,4283,4100,3080,4184,2875,13603,1575,38340,351,111,99,5,566
CAQUETA,BELEN DE LOS ANDAQUIES,18094,3377,3256,3696,3274,3776,2739,10835,1473,32426,292,107,74,5,478
CAQUETA,CARTAGENA DEL CHAIRA,18150,44056,47400,34664,42947,41132,44107,114493,10018,378817,607,886,1219,63,2775
CAQUETA,CURILLO,18205,2945,2798,2761,2101,2790,1842,8004,971,24212,198,98,46,5,347
CAQUETA,EL DONCELLO,18247,7318,7272,6127,4465,7132,4027,22159,2096,60596,429,218,161,8,816
CAQUETA,EL PAUJIL,18256,10182,10747,9303,6622,10291,3824,29595,1845,82409,456,305,249,6,1016
CAQUETA,LA MONTAÑITA,18410,10577,10841,8386,6616,10132,4144,29395,2660,82751,719,294,196,7,1216
CAQUETA,MILAN,18460,8593,8764,6935,6194,7564,6268,21837,3197,69352,242,177,172,17,608
CAQUETA,MORELIA,18479,4329,3783,3423,2137,3653,2146,11082,1180,31733,191,79,83,7,360
CAQUETA,PUERTO RICO,18592,24654,25269,21490,18172,22781,15388,69020,5953,202727,1103,566,559,34,2262
CAQUETA,SAN JOSE DEL FRAGUA,18610,3103,2714,2728,2152,2989,1890,8566,806,24948,309,81,62,1,453
CAQUETA,SAN VICENTE DEL CAGUAN,18753,102800,100250,98240,107073,91552,93442,276782,25151,895290,1933,1628,2626,220,6407
CAQUETA,SOLANO,18756,5066,5539,3828,3669,4191,4683,11998,2048,41022,192,125,113,5,435
CAQUETA,SOLITA,18785,3637,4055,3366,3195,4272,2593,11919,797,33834,286,121,81,3,491
CAQUETA,VALPARAISO,18860,8536,8665,7391,5630,9465,5424,24577,2759,72447,373,242,183,12,810
CAUCA,POPAYAN,19001,1745,1494,1960,1960,1408,759,4835,285,14446,1059,30,11,0,1100
CAUCA,ALMAGUER,19022,420,495,393,365,285,187,1281,74,3500,471,2,0,0,473
CAUCA,ARGELIA,19050,266,279,316,497,377,159,480,52,2426,187,3,2,0,192
CAUCA,BALBOA,19075,655,578,763,1127,817,867,1757,336,6900,323,16,10,0,349
CAUCA,BOLIVAR,19100,934,1054,1010,941,1104,739,3499,261,9542,575,19,11,0,605
CAUCA,BUENOS AIRES,19110,365,300,611,571,457,313,1161,182,3960,174,6,4,0,184
CAUCA,CAJIBIO,19130,658,641,599,596,756,328,2171,115,5864,653,8,6,0,667
CAUCA,CALDONO,19137,247,333,389,311,198,158,902,78,2616,321,2,0,0,323
CAUCA,CALOTO,19142,1206,1290,1196,1417,825,423,2463,136,8956,317,16,8,3,344
CAUCA,CORINTO,19212,542,753,598,1154,561,1205,1785,126,6724,209,14,5,2,230
CAUCA,EL TAMBO,19256,1157,1413,2296,1867,1443,869,4946,1129,15120,1166,16,12,0,1194
CAUCA,FLORENCIA,19290,57,105,192,223,446,162,105,12,1302,87,5,0,0,92
CAUCA,GUACHENE,19300,146,135,110,97,124,12,359,8,991,33,7,0,0,40
CAUCA,GUAPI,19318,3,6,3,4,1,10,20,29,76,4,0,0,0,4
CAUCA,INZA,19355,151,237,651,1049,253,264,904,45,3554,260,6,1,0,267
CAUCA,JAMBALO,19364,133,92,223,494,314,212,393,47,1908,275,2,0,0,277
CAUCA,LA SIERRA,19392,496,374,608,627,606,454,1319,210,4694,324,4,3,1,332
CAUCA,LA VEGA,19397,418,676,592,594,680,115,951,59,4085,405,10,2,0,417
CAUCA,LOPEZ DE MICAY,19418,0,3,1,3,3,4,5,1,20,2,0,0,0,2
CAUCA,MERCADERES,19450,2690,2340,2166,2528,2471,2408,6575,1174,22352,239,59,58,3,359
CAUCA,MIRANDA,19455,133,82,244,115,209,64,219,16,1082,71,2,0,0,73
CAUCA,MORALES,19473,254,200,371,303,749,239,581,71,2768,289,4,0,0,293
CAUCA,PADILLA,19513,35,34,58,23,69,22,114,20,375,23,0,0,0,23
CAUCA,PAEZ,19517,549,1003,1344,2118,1712,570,2419,304,10019,646,23,3,0,672
CAUCA,PATIA,19532,3964,3511,4226,4280,4216,4751,9998,1962,36908,575,95,58,7,735
CAUCA,PIAMONTE,19533,1465,1652,1320,1826,2078,1719,4550,670,15280,331,66,23,0,420
CAUCA,PIENDAMO,19548,248,199,341,376,102,172,1589,101,3128,364,4,1,0,369
CAUCA,PUERTO TEJADA,19573,49,61,62,23,44,8,82,7,336,31,0,0,0,31
CAUCA,PURACE,19585,3215,3915,2555,2699,992,837,8358,318,22889,1531,38,3,0,1572
CAUCA,ROSAS,19622,460,560,647,775,1211,633,1166,101,5553,569,5,1,0,575
CAUCA,SAN SEBASTIAN,19693,647,856,651,1240,609,754,2241,277,7275,617,13,9,0,639
CAUCA,SANTANDER DE QUILICHAO,19698,1790,1465,1289,1091,1516,875,4349,399,12774,576,26,13,2,617
CAUCA,SANTA ROSA,19701,358,419,462,1124,566,551,921,182,4583,319,12,0,0,331
CAUCA,SILVIA,19743,1742,1944,1939,1143,1074,499,6054,177,14572,1538,9,1,0,1548
CAUCA,SOTARA,19760,1482,1522,1462,1789,1016,959,3727,193,12150,957,12,8,0,977
CAUCA,SUAREZ,19780,39,7,149,574,683,153,265,15,1885,155,2,0,0,157
CAUCA,SUCRE,19785,407,363,408,516,510,457,1248,235,4144,199,8,5,0,212
CAUCA,TIMBIO,19807,923,723,1135,1151,1209,705,2161,284,8291,586,20,3,1,610
CAUCA,TIMBIQUI,19809,0,2,1,2,4,3,4,4,20,3,0,0,0,3
CAUCA,TORIBIO,19821,733,626,803,959,348,289,2001,117,5876,426,11,2,0,439
CAUCA,TOTORO,19824,1919,2025,1613,1629,1390,1018,4267,308,14169,849,20,16,0,885
CAUCA,VILLA RICA,19845,95,87,129,55,102,243,351,41,1103,39,2,3,0,44
CESAR,VALLEDUPAR,20001,29064,27720,29065,26652,23215,16741,84762,5783,243002,957,294,402,118,1771
CESAR,AGUACHICA,20011,9856,9260,10477,11775,11026,12121,27270,3358,95143,530,159,206,33,928
CESAR,AGUSTIN CODAZZI,20013,10606,10030,11383,11413,10197,9992,30838,2892,97351,390,103,130,57,680
CESAR,ASTREA,20032,9501,9408,8020,8988,7830,5010,24592,1696,75045,395,158,147,22,722
CESAR,BECERRIL,20045,7318,6861,7094,5411,7817,3434,21617,1160,60712,330,136,126,10,602
CESAR,BOSCONIA,20060,8282,7437,6351,5732,7624,6162,20661,1109,63358,90,55,90,28,263
CESAR,CHIMICHAGUA,20175,10002,9793,8627,7800,9510,4012,30154,2435,82333,749,226,172,18,1165
CESAR,CHIRIGUANA,20178,8034,8872,8545,9073,9531,2834,26973,1445,75307,312,159,147,27,645
CESAR,CURUMANI,20228,8359,8857,8526,9633,9830,4750,22903,1921,74779,468,224,195,12,899
CESAR,EL COPEY,20238,7038,7382,6724,6884,8389,4426,19491,1253,61587,518,189,132,9,848
CESAR,EL PASO,20250,6766,6783,6935,4964,8208,1396,19801,1234,56087,152,110,149,15,426
CESAR,GAMARRA,20295,4930,4668,4540,5157,4789,5045,13795,2137,45061,141,80,114,14,349
CESAR,GONZALEZ,20310,186,180,189,116,194,126,514,37,1542,109,4,2,0,115
CESAR,LA GLORIA,20383,9070,9971,11082,14325,11001,8771,26295,2983,93498,392,198,246,25,861
CESAR,LA JAGUA DE IBIRICO,20400,3492,3266,3288,3016,3960,1803,9421,610,28856,326,80,54,8,468
CESAR,MANAURE BALCON DEL CESAR,20443,396,366,332,329,244,271,1248,115,3301,89,10,5,0,104
CESAR,PAILITAS,20517,5557,6142,6475,8546,6862,3910,17245,1004,55741,322,189,147,9,667
CESAR,PELAYA,20550,5744,5986,6870,6036,6684,3000,16717,1040,52077,241,193,165,3,602
CESAR,PUEBLO BELLO,20570,887,753,629,665,1178,361,2556,189,7218,161,21,18,0,200
CESAR,RIO DE ORO,20614,6197,5512,5518,5640,6194,4716,16628,1629,52034,303,121,109,17,550
CESAR,LA PAZ,20621,6771,6433,6465,5236,5976,2690,19886,1129,54586,233,81,104,24,442
CESAR,SAN ALBERTO,20710,7057,6738,7574,8621,7234,9317,20020,3157,69718,332,91,132,31,586
CESAR,SAN DIEGO,20750,8828,8351,6701,6967,7063,4253,24525,1655,68343,212,94,147,29,482
CESAR,SAN MARTIN,20770,12221,11996,13091,11603,12675,11752,35931,4915,114184,370,153,210,48,781
CESAR,TAMALAMEQUE,20787,5846,6223,5956,6068,6513,2327,18036,1029,51998,377,148,134,10,669
CORDOBA,MONTERIA,23001,37430,34436,38082,79171,35488,99472,110242,10715,445036,2709,491,631,201,4032
CORDOBA,AYAPEL,23068,14476,13743,13037,9546,13796,7397,44298,3271,119564,636,227,215,43,1121
CORDOBA,BUENAVISTA,23079,10846,10217,12161,11134,12992,18182,30865,3922,110319,337,96,136,64,633
CORDOBA,CANALETE,23090,4174,3683,3871,11542,2628,8588,10789,1083,46358,368,76,76,16,536
CORDOBA,CERETE,23162,4842,4386,4108,7814,3783,4946,14564,917,45360,631,95,74,15,815
CORDOBA,CHIMA,23168,4642,4427,3517,3308,4025,1052,12728,724,34423,495,109,65,4,673
CORDOBA,CHINU,23182,12042,11346,10888,9319,9447,5009,34102,3077,95230,1302,156,204,24,1686
CORDOBA,CIENAGA DE ORO,23189,9355,9158,9366,14489,8894,10893,28086,3195,93436,1153,197,174,25,1549
CORDOBA,COTORRA,23300,1400,1382,935,1078,730,316,3508,79,9428,282,30,14,0,326
CORDOBA,LA APARTADA,23350,3034,2375,2559,2361,2903,3375,9346,730,26683,66,20,37,13,136
CORDOBA,LORICA,23417,14791,14183,11664,16840,12000,6955,40432,2432,119297,1483,323,268,20,2094
CORDOBA,LOS CORDOBAS,23419,3478,3357,4073,8819,3155,6948,10159,596,40585,364,53,73,15,505
CORDOBA,MOMIL,23464,2030,2072,2313,2611,2446,2022,6239,369,20102,267,34,39,4,344
CORDOBA,MONTELIBANO,23466,11295,9609,10211,9559,9177,9777,31097,4973,95698,620,124,145,45,934
CORDOBA,MOÑITOS,23500,1146,1576,1198,1259,1285,262,5522,285,12533,321,40,19,0,380
CORDOBA,PLANETA RICA,23555,19635,16575,20630,22989,20914,18468,52705,7883,179799,789,181,308,81,1359
CORDOBA,PUEBLO NUEVO,23570,11148,10747,10288,11760,11556,10791,33626,4062,103978,941,155,160,46,1302
CORDOBA,PUERTO ESCONDIDO,23574,6364,5418,5518,7385,5177,3356,17536,1190,51944,661,126,91,11,889
CORDOBA,PUERTO LIBERTADOR,23580,10745,9257,11408,9794,10884,9073,30599,3340,95100,749,173,167,36,1125
CORDOBA,PURISIMA DE LA CONCEPCION,23586,1892,2138,1404,2366,2019,277,5480,439,16015,316,44,27,2,389
CORDOBA,SAHAGUN,23660,19240,17823,18782,19573,18075,9689,54979,5455,163616,1641,311,314,43,2309
CORDOBA,SAN ANDRES DE SOTAVENTO,23670,3804,3652,2660,3164,3163,1066,9740,748,27997,914,64,44,5,1027
CORDOBA,SAN ANTERO,23672,2248,1960,2274,2299,1765,1242,6339,374,18501,271,40,35,5,351
CORDOBA,SAN BERNARDO DEL VIENTO,23675,3834,3764,2658,3267,3582,476,11001,601,29183,438,90,66,1,595
CORDOBA,SAN CARLOS,23678,6799,6583,6459,10395,6812,7590,19456,2345,66439,733,128,144,16,1021
CORDOBA,SAN JOSE DE URE,23682,2649,2580,3798,3056,2852,2721,8791,901,27348,273,40,43,11,367
CORDOBA,SAN PELAYO,23686,9184,8387,6968,9160,8393,4100,24672,1844,72708,981,169,165,15,1330
CORDOBA,TIERRALTA,23807,14893,14428,12364,18842,13485,22506,43056,6326,145900,1264,336,254,41,1895
CORDOBA,TUCHIN,23815,1192,999,981,192,1449,93,3027,224,8157,452,22,7,0,481
CORDOBA,VALENCIA,23855,6778,5892,8095,12134,6445,15579,22324,5189,82436,1059,148,119,29,1355
CUNDINAMARCA,AGUA DE DIOS,25001,536,536,730,1125,539,576,1827,250,6119,159,21,14,0,194
CUNDINAMARCA,ALBAN,25019,397,267,567,533,313,259,1120,25,3481,280,10,1,0,291
CUNDINAMARCA,ANAPOIMA,25035,302,314,366,744,337,858,730,139,3790,150,8,8,0,166
CUNDINAMARCA,ANOLAIMA,25040,887,928,977,1934,962,1025,2014,259,8986,683,26,9,0,718
CUNDINAMARCA,ARBELAEZ,25053,749,847,1032,1159,879,906,2010,423,8005,415,18,8,0,441
CUNDINAMARCA,BELTRAN,25086,416,626,501,959,699,597,1292,95,5185,68,11,14,1,94
CUNDINAMARCA,BITUIMA,25095,254,258,392,498,258,476,684,111,2931,217,5,1,0,223
CUNDINAMARCA,BOJACA,25099,899,478,576,665,799,432,1995,151,5995,205,13,11,1,230
CUNDINAMARCA,CABRERA,25120,982,1093,1157,1348,898,1038,2747,209,9472,537,18,5,0,560
CUNDINAMARCA,CACHIPAY,25123,228,257,339,410,167,136,679,59,2275,167,7,3,0,177
CUNDINAMARCA,CAJICA,25126,1104,326,754,492,757,170,1858,45,5506,231,11,10,1,253
CUNDINAMARCA,CAPARRAPI,25148,5462,5527,8170,8955,6165,2652,15549,1093,53573,891,210,121,1,1223
CUNDINAMARCA,CAQUEZA,25151,843,1133,1288,1065,865,792,2961,210,9157,1397,5,0,0,1402
CUNDINAMARCA,CARMEN DE CARUPA,25154,1606,1192,2016,1483,1746,1414,10623,242,20322,1804,26,3,0,1833
CUNDINAMARCA,CHAGUANI,25168,946,768,900,755,1009,459,2730,267,7834,368,21,7,0,396
CUNDINAMARCA,CHIA,25175,999,459,1249,605,698,187,1915,41,6153,380,11,9,1,401
CUNDINAMARCA,CHIPAQUE,25178,904,1099,1181,1516,1011,886,2484,192,9273,856,10,1,0,867
CUNDINAMARCA,CHOACHI,25181,1264,1543,1422,1432,817,669,4317,64,11528,1441,11,1,0,1453
CUNDINAMARCA,CHOCONTA,25183,4840,3068,4400,1638,3549,950,13408,506,32359,1777,54,42,0,1873
CUNDINAMARCA,COGUA,25200,2598,775,2917,1043,2849,674,9484,133,20473,1037,54,21,0,1112
CUNDINAMARCA,COTA,25214,728,186,580,298,725,124,1341,44,4026,190,11,8,0,209
CUNDINAMARCA,CUCUNUBA,25224,911,564,815,504,507,263,3251,27,6842,742,7,5,0,754
CUNDINAMARCA,EL COLEGIO,25245,722,625,670,885,519,616,1889,144,6070,452,9,6,1,468
CUNDINAMARCA,EL PEÑON,25258,326,437,1025,1517,885,898,1076,92,6256,549,11,1,0,561
CUNDINAMARCA,EL ROSAL,25260,1863,865,1616,783,1135,308,4669,96,11335,312,43,21,0,376
CUNDINAMARCA,FACATATIVA,25269,2965,1156,2308,1405,2714,658,6269,84,17559,471,57,44,0,572
CUNDINAMARCA,FOMEQUE,25279,953,1341,1811,3524,1226,3019,3569,608,16051,1666,20,3,0,1689
CUNDINAMARCA,FOSCA,25281,473,881,440,621,488,598,2117,91,5709,884,1,0,0,885
CUNDINAMARCA,FUNZA,25286,1178,287,894,337,1467,166,4382,20,8731,117,34,22,2,175
CUNDINAMARCA,FUQUENE,25288,1900,350,1712,220,1545,72,7660,15,13474,952,28,13,0,993
CUNDINAMARCA,FUSAGASUGA,25290,1395,1363,1663,2079,1439,1512,3857,360,13668,884,39,15,1,939
CUNDINAMARCA,GACHALA,25293,639,870,837,1058,1336,1554,3364,1055,10713,1142,11,1,0,1154
CUNDINAMARCA,GACHANCIPA,25295,1411,319,1073,343,1112,209,4220,81,8768,277,19,22,0,318
CUNDINAMARCA,GACHETA,25297,1303,1211,2437,2560,2822,3461,4350,328,18472,2241,8,0,0,2249
CUNDINAMARCA,GAMA,25299,377,569,692,724,681,966,1615,213,5837,860,0,0,0,860
CUNDINAMARCA,GIRARDOT,25307,519,563,494,1216,608,726,1615,176,5917,109,11,15,0,135
CUNDINAMARCA,GRANADA,25312,713,429,1073,849,853,344,1763,127,6151,278,14,10,0,302
CUNDINAMARCA,GUACHETA,25317,2971,771,2510,641,2729,257,10760,44,20683,1296,38,25,2,1361
CUNDINAMARCA,GUADUAS,25320,7221,7052,8990,5398,8106,2624,19644,1531,60566,877,153,134,11,1175
CUNDINAMARCA,GUASCA,25322,2653,701,3211,868,2913,434,10511,145,21436,1130,65,24,1,1220
CUNDINAMARCA,GUATAQUI,25324,216,341,164,200,290,270,659,48,2188,58,8,3,0,69
CUNDINAMARCA,GUATAVITA,25326,1174,534,1451,699,878,270,6630,155,11791,942,21,2,0,965
CUNDINAMARCA,GUAYABAL DE SIQUIMA,25328,271,325,429,955,337,376,657,117,3467,325,2,1,0,328
CUNDINAMARCA,GUAYABETAL,25335,213,337,363,404,330,264,911,96,2918,344,3,0,0,347
CUNDINAMARCA,GUTIERREZ,25339,445,654,374,535,396,535,1971,285,5195,459,6,0,0,465
CUNDINAMARCA,JERUSALEN,25368,269,350,513,1369,422,983,1220,297,5423,179,12,12,0,203
CUNDINAMARCA,JUNIN,25372,1845,1826,2468,2421,1873,2400,5134,853,18820,1892,14,1,0,1907
CUNDINAMARCA,LA CALERA,25377,3484,2363,3878,2720,2880,1194,9809,371,26699,1502,51,21,0,1574
CUNDINAMARCA,LA MESA,25386,595,505,780,751,604,505,1713,235,5688,370,17,8,0,395
CUNDINAMARCA,LA PALMA,25394,494,713,964,1481,695,1111,1522,302,7282,437,15,5,0,457
CUNDINAMARCA,LA PEÑA,25398,369,344,627,633,304,498,898,140,3813,257,11,2,0,270
CUNDINAMARCA,LA VEGA,25402,800,693,780,830,964,803,1869,197,6936,465,17,4,0,486
CUNDINAMARCA,LENGUAZAQUE,25407,2387,1229,1589,803,1674,299,7149,79,15209,1286,12,14,1,1313
CUNDINAMARCA,MACHETA,25426,1850,2034,1341,1663,1991,1285,4846,505,15515,1002,19,3,0,1024
CUNDINAMARCA,MADRID,25430,2142,874,1692,831,2285,336,5534,34,13728,252,33,26,4,315
CUNDINAMARCA,MANTA,25436,815,1057,805,1158,831,975,2807,546,8994,965,7,4,0,976
CUNDINAMARCA,MEDINA,25438,5661,6036,6430,8930,5793,12735,16297,5463,67345,1257,289,125,2,1673
CUNDINAMARCA,MOSQUERA,25473,1224,441,940,611,1122,312,3190,32,7872,83,14,33,0,130
CUNDINAMARCA,NARIÑO,25483,118,111,89,47,575,125,276,265,1606,30,6,0,1,37
CUNDINAMARCA,NEMOCON,25486,2219,523,1733,865,2236,397,6763,101,14837,420,35,37,1,493
CUNDINAMARCA,NILO,25488,482,480,597,1171,488,1020,1930,260,6428,159,21,15,0,195
CUNDINAMARCA,NIMAIMA,25489,129,248,213,562,311,212,287,26,1988,118,8,1,0,127
CUNDINAMARCA,NOCAIMA,25491,140,279,264,324,239,470,567,42,2325,190,4,1,0,195
CUNDINAMARCA,VENECIA,25506,239,332,271,459,296,271,788,61,2717,213,6,1,0,220
CUNDINAMARCA,PACHO,25513,3530,2672,4006,4371,3101,2306,7967,468,28421,1881,75,24,0,1980
CUNDINAMARCA,PAIME,25518,628,661,766,871,950,575,1441,166,6058,521,10,1,0,532
CUNDINAMARCA,PANDI,25524,376,340,459,732,408,241,1087,223,3866,234,3,6,1,244
CUNDINAMARCA,PARATEBUENO,25530,6516,6841,6942,9212,6408,10023,20979,7289,74210,463,149,147,23,782
CUNDINAMARCA,PASCA,25535,1854,2049,1511,2180,1363,2031,5615,615,17218,988,41,2,0,1031
CUNDINAMARCA,PUERTO SALGAR,25572,5678,5142,7435,7289,5948,9361,16900,2792,60545,340,91,133,21,585
CUNDINAMARCA,PULI,25580,731,764,1077,1033,883,564,2615,278,7945,271,27,12,0,310
CUNDINAMARCA,QUEBRADANEGRA,25592,347,398,495,574,348,427,1117,136,3842,230,10,2,0,242
CUNDINAMARCA,QUETAME,25594,204,606,311,364,310,539,1691,213,4238,532,1,0,0,533
CUNDINAMARCA,QUIPILE,25596,413,488,472,726,483,326,994,225,4127,458,4,2,0,464
CUNDINAMARCA,APULO,25599,318,433,408,850,540,470,975,87,4081,147,10,8,0,165
CUNDINAMARCA,RICAURTE,25612,687,770,751,1429,817,1644,2250,474,8822,131,7,20,3,161
CUNDINAMARCA,SAN ANTONIO DEL TEQUENDAMA,25645,576,560,634,743,353,385,1634,105,4990,494,9,1,0,504
CUNDINAMARCA,SAN BERNARDO,25649,676,734,889,1416,651,810,1556,142,6874,549,8,3,0,560
CUNDINAMARCA,SAN CAYETANO,25653,1890,1251,2641,1908,2060,1330,5955,309,17344,768,46,15,0,829
CUNDINAMARCA,SAN FRANCISCO,25658,796,601,828,1229,879,1073,1690,136,7232,307,21,13,0,341
CUNDINAMARCA,SAN JUAN DE RIOSECO,25662,1815,1787,1702,1445,1978,1061,5483,610,15881,511,43,23,0,577
CUNDINAMARCA,SASAIMA,25718,427,329,673,717,581,299,755,157,3938,323,5,6,0,334
CUNDINAMARCA,SESQUILE,25736,1818,705,1747,790,1950,455,6832,260,14557,751,33,22,0,806
CUNDINAMARCA,SIBATE,25740,2207,1331,1705,856,2130,787,4732,195,13943,646,47,13,0,706
CUNDINAMARCA,SILVANIA,25743,859,688,1631,1381,575,862,2710,186,8892,631,15,9,0,655
CUNDINAMARCA,SIMIJACA,25745,3050,359,2623,274,2759,88,12194,14,21361,1252,42,29,0,1323
CUNDINAMARCA,SOACHA,25754,1876,709,1544,502,1084,187,3754,37,9693,274,10,16,3,303
CUNDINAMARCA,SOPO,25758,3229,810,2684,762,2300,235,6505,57,16582,325,42,41,2,410
CUNDINAMARCA,SUBACHOQUE,25769,3049,1493,2623,2004,2382,1052,7117,261,19981,863,75,26,0,964
CUNDINAMARCA,SUESCA,25772,2907,1146,2535,913,1972,367,8475,81,18396,1190,33,21,1,1245
CUNDINAMARCA,SUPATA,25777,937,572,1004,1508,1180,1009,2409,337,8956,428,24,13,0,465
CUNDINAMARCA,SUSA,25779,1623,461,1953,625,1255,235,7821,28,14001,1355,7,5,2,1369
CUNDINAMARCA,SUTATAUSA,25781,376,272,415,555,166,277,841,19,2921,380,2,2,0,384
CUNDINAMARCA,TABIO,25785,1982,1295,1777,950,1701,417,3504,236,11862,601,40,13,1,655
CUNDINAMARCA,TAUSA,25793,1660,1276,1960,1992,2132,1323,5112,195,15650,1063,31,12,0,1106
CUNDINAMARCA,TENA,25797,281,175,346,398,196,260,638,51,2345,228,3,0,0,231
CUNDINAMARCA,TENJO,25799,3408,790,2562,738,2458,341,8913,115,19325,641,53,48,0,742
CUNDINAMARCA,TIBACUY,25805,326,370,538,798,444,482,847,123,3928,292,7,5,0,304
CUNDINAMARCA,TIBIRITA,25807,449,449,456,465,477,320,1347,178,4141,440,3,0,0,443
CUNDINAMARCA,TOCAIMA,25815,1059,1270,1391,3571,1139,3947,3013,2026,17416,251,47,40,4,342
CUNDINAMARCA,TOCANCIPA,25817,1142,312,1011,458,1017,53,4206,32,8231,286,12,22,1,321
CUNDINAMARCA,TOPAIPI,25823,580,571,1047,995,598,774,1964,138,6667,534,8,1,0,543
CUNDINAMARCA,UBALA,25839,2118,2461,2665,2527,2951,2496,7121,1100,23439,1855,54,11,0,1920
CUNDINAMARCA,UBAQUE,25841,871,866,957,974,912,472,1829,113,6994,949,5,0,0,954
CUNDINAMARCA,VILLA DE SAN DIEGO DE UBATE,25843,2898,946,2269,975,2695,585,9495,128,19991,1455,41,21,1,1518
CUNDINAMARCA,UNE,25845,665,750,863,1858,686,1223,2090,351,8486,639,21,3,0,663
CUNDINAMARCA,UTICA,25851,596,618,810,1343,717,696,1795,194,6769,142,24,13,0,179
CUNDINAMARCA,VERGARA,25862,404,480,710,1619,554,1142,1096,109,6114,432,12,1,0,445
CUNDINAMARCA,VIANI,25867,249,226,266,408,373,258,638,45,2463,254,0,0,0,254
CUNDINAMARCA,VILLAGOMEZ,25871,316,386,543,645,647,487,924,56,4004,308,5,1,0,314
CUNDINAMARCA,VILLAPINZON,25873,3988,2524,3172,1336,1837,465,13803,140,27265,1905,43,7,0,1955
CUNDINAMARCA,VILLETA,25875,414,425,610,624,557,465,1275,189,4559,287,17,3,0,307
CUNDINAMARCA,VIOTA,25878,450,760,507,805,637,811,2064,292,6326,384,21,5,0,410
CUNDINAMARCA,YACOPI,25885,7196,7043,10401,15831,7439,4634,18580,1334,72458,1748,242,121,4,2115
CUNDINAMARCA,ZIPACON,25898,289,248,388,373,523,192,864,54,2931,166,9,4,0,179
CUNDINAMARCA,ZIPAQUIRA,25899,4343,1452,3893,1435,3318,735,12438,271,27885,1077,70,42,2,1191
CHOCO,QUIBDO,27001,24,13,18,20,43,14,59,13,204,14,1,0,0,15
CHOCO,ACANDI,27006,5405,4999,6234,3141,4172,1303,16984,807,43045,221,68,58,18,365
CHOCO,ALTO BAUDO,27025,2,17,21,19,19,18,64,12,172,13,0,0,0,13
CHOCO,ATRATO,27050,5,6,1,0,4,2,32,3,53,6,0,0,0,6
CHOCO,BAGADO,27073,5,18,12,4,15,10,21,8,93,12,0,0,0,12
CHOCO,BAHIA SOLANO,27075,439,287,281,151,431,182,1622,184,3577,172,9,3,0,184
CHOCO,BAJO BAUDO,27077,54,31,44,23,43,12,102,8,317,10,1,0,0,11
CHOCO,BOJAYA,27099,66,58,106,81,196,27,169,31,734,28,2,1,0,31
CHOCO,EL CANTON DEL SAN PABLO,27135,29,34,23,22,34,8,89,14,253,9,1,0,0,10
CHOCO,CARMEN DEL DARIEN,27150,2458,2187,2820,2658,3113,950,7824,458,22468,289,57,47,3,396
CHOCO,CERTEGUI,27160,0,2,5,1,13,1,12,2,36,5,0,0,0,5
CHOCO,CONDOTO,27205,6,9,11,11,16,33,39,6,131,6,0,0,0,6
CHOCO,EL CARMEN DE ATRATO,27245,655,610,897,1128,841,1287,1873,314,7605,180,36,11,0,227
CHOCO,EL LITORAL DEL SAN JUAN,27250,0,0,0,0,0,0,0,0,0,0,0,0,0,0
CHOCO,ISTMINA,27361,5,50,34,26,55,33,162,36,401,29,0,0,0,29
CHOCO,JURADO,27372,169,148,43,41,100,38,273,51,863,32,3,0,0,35
CHOCO,LLORO,27413,1,1,5,1,6,1,6,2,23,4,0,0,0,4
CHOCO,MEDIO ATRATO,27425,1,2,0,0,3,6,0,3,15,3,0,0,0,3
CHOCO,MEDIO BAUDO,27430,4,4,2,1,13,2,9,3,38,6,0,0,0,6
CHOCO,MEDIO SAN JUAN,27450,0,0,0,0,0,0,0,0,0,0,0,0,0,0
CHOCO,NOVITA,27491,141,107,106,134,139,105,447,115,1294,59,1,1,0,61
CHOCO,NUQUI,27495,5,0,10,3,39,120,167,30,374,9,15,0,0,24
CHOCO,RIO IRO,27580,16,136,98,107,138,112,283,127,1017,57,1,0,0,58
CHOCO,RIO QUITO,27600,2,1,1,1,0,1,7,2,15,2,0,0,0,2
CHOCO,RIOSUCIO,27615,3699,3132,3556,4202,3127,3936,10415,907,32974,264,97,91,5,457
CHOCO,SAN JOSE DEL PALMAR,27660,196,227,225,250,387,341,1016,117,2759,83,2,2,1,88
CHOCO,SIPI,27745,2,0,0,0,1,0,8,7,18,2,0,0,0,2
CHOCO,TADO,27787,33,24,24,14,24,5,67,27,218,17,0,0,0,17
CHOCO,UNGUIA,27800,7561,6230,8082,5007,6601,3297,22940,1179,60897,176,77,120,25,398
CHOCO,UNION PANAMERICANA,27810,5,3,2,1,14,3,8,1,37,5,0,0,0,5
HUILA,NEIVA,41001,3320,2778,3939,2084,3600,973,8598,560,25852,607,89,51,1,748
HUILA,ACEVEDO,41006,275,261,375,471,340,351,836,75,2984,280,6,0,0,286
HUILA,AGRADO,41013,1017,935,920,706,1418,363,2855,177,8391,176,30,18,0,224
HUILA,AIPE,41016,3935,3581,4211,2115,4341,1119,12169,779,32250,597,110,66,2,775
HUILA,ALGECIRAS,41020,1680,1977,1961,1741,1829,1095,4716,470,15469,572,50,14,1,637
HUILA,ALTAMIRA,41026,1335,1356,1618,915,1292,698,4056,347,11617,161,43,27,0,231
HUILA,BARAYA,41078,2904,2859,3240,2788,3470,1398,8460,801,25920,499,66,45,3,613
HUILA,CAMPOALEGRE,41132,1575,1296,1651,1025,1610,459,4517,304,12437,389,50,13,0,452
HUILA,COLOMBIA,41206,2595,2613,2716,2480,3155,2002,7459,963,23983,602,72,36,1,711
HUILA,ELIAS,41244,682,615,679,812,676,532,1739,157,5892,111,11,13,1,136
HUILA,GARZON,41298,1418,1192,1561,1163,1464,811,3830,431,11870,512,31,15,0,558
HUILA,GIGANTE,41306,1897,1674,1959,1208,1796,678,5102,362,14676,393,39,34,0,466
HUILA,GUADALUPE,41319,456,403,715,618,731,285,1635,163,5006,148,11,8,0,167
HUILA,HOBO,41349,612,614,991,433,1135,82,2039,134,6040,117,17,14,1,149
HUILA,IQUIRA,41357,930,1055,636,726,905,403,2985,216,7856,294,21,14,0,329
HUILA,ISNOS,41359,507,553,605,928,698,984,1782,227,6284,408,15,1,0,424
HUILA,LA ARGENTINA,41378,467,368,426,502,394,462,1458,132,4209,281,5,3,0,289
HUILA,LA PLATA,41396,1894,2040,2135,2086,2265,1194,6520,827,18961,785,60,24,0,869
HUILA,NATAGA,41483,352,281,653,435,460,223,1114,102,3620,190,9,4,0,203
HUILA,OPORAPA,41503,140,136,256,330,124,709,689,519,2903,207,3,1,0,211
HUILA,PAICOL,41518,1827,1575,1622,934,1746,447,5770,421,14342,314,38,34,1,387
HUILA,PALERMO,41524,4030,3639,4064,1661,4158,589,12248,773,31162,603,97,60,4,764
HUILA,PALESTINA,41530,143,122,196,167,150,172,394,76,1420,166,0,0,0,166
HUILA,PITAL,41548,1079,923,808,394,1019,385,2797,160,7565,221,25,16,0,262
HUILA,PITALITO,41551,1896,2034,2331,3842,2334,4286,5741,1926,24390,1076,68,38,0,1182
HUILA,RIVERA,41615,2104,1861,1641,790,1564,329,5595,368,14252,370,47,31,0,448
HUILA,SALADOBLANCO,41660,398,441,496,813,481,1012,1181,305,5127,267,13,4,0,284
HUILA,SAN AGUSTIN,41668,640,621,898,1011,739,822,1355,143,6229,501,18,4,0,523
HUILA,SANTA MARIA,41676,781,733,877,913,655,691,2026,178,6854,439,16,2,0,457
HUILA,SUAZA,41770,870,691,1401,895,1088,656,2894,380,8875,232,27,16,0,275
HUILA,TARQUI,41791,1917,1776,2459,1736,2131,747,6137,452,17355,379,52,31,2,464
HUILA,TESALIA,41797,2251,2211,1673,979,2574,489,6718,641,17536,374,65,31,0,470
HUILA,TELLO,41799,1953,1873,2137,1437,2036,824,6207,516,16983,318,34,38,3,393
HUILA,TERUEL,41801,670,643,1031,532,1036,209,2142,139,6402,168,18,16,0,202
HUILA,TIMANA,41807,950,841,957,1611,902,1307,2565,348,9481,285,42,15,0,342
HUILA,VILLAVIEJA,41872,1634,1556,1710,626,1784,199,4612,309,12430,247,48,23,0,318
HUILA,YAGUARA,41885,2589,2162,2157,657,1711,311,6242,315,16144,164,31,41,4,240
LA GUAJIRA,RIOHACHA,44001,9934,9634,7824,5171,8854,2583,24884,1286,70170,773,229,167,8,1177
LA GUAJIRA,ALBANIA,44035,2692,2712,2042,1446,2445,713,6959,375,19384,172,51,49,3,275
LA GUAJIRA,BARRANCAS,44078,2931,3225,2281,1902,2518,876,7729,462,21924,242,74,55,0,371
LA GUAJIRA,DIBULLA,44090,2700,2299,2386,2572,2700,1415,6652,489,21213,273,48,44,3,368
LA GUAJIRA,DISTRACCION,44098,1089,1019,837,550,1032,204,3025,164,7920,128,33,20,0,181
LA GUAJIRA,EL MOLINO,44110,1363,1339,1586,840,1578,176,3516,231,10629,93,42,26,0,161
LA GUAJIRA,FONSECA,44279,2453,2380,1959,1847,2360,833,6883,379,19094,251,82,32,3,368
LA GUAJIRA,HATONUEVO,44378,571,545,480,506,501,178,1674,79,4534,76,20,9,0,105
LA GUAJIRA,LA JAGUA DEL PILAR,44420,1390,1361,1082,930,1287,209,3940,234,10433,40,23,30,1,94
LA GUAJIRA,MAICAO,44430,2772,2861,2262,2032,2757,1095,8349,434,22562,270,82,54,0,406
LA GUAJIRA,MANAURE,44560,691,423,477,151,499,80,1213,91,3625,203,7,1,0,211
LA GUAJIRA,SAN JUAN DEL CESAR,44650,8214,7850,5206,4121,6476,1010,22325,1168,56370,604,174,127,8,913
LA GUAJIRA,URIBIA,44847,2234,2053,1551,931,1039,346,6688,244,15086,338,61,27,0,426
LA GUAJIRA,URUMITA,44855,1023,937,997,861,1294,602,2616,144,8474,73,26,22,1,122
LA GUAJIRA,VILLANUEVA,44874,2522,2334,2017,1963,2743,918,6332,427,19256,128,71,40,5,244
MAGDALENA,SANTA MARTA,47001,846,786,1134,1179,1390,1619,3190,231,10375,27,13,27,5,72
MAGDALENA,ALGARROBO,47030,4860,5032,5602,6556,6643,5269,15751,1598,51311,71,49,102,29,251
MAGDALENA,ARACATACA,47053,2277,2232,2044,1990,3125,1325,7814,778,21585,66,28,41,9,144
MAGDALENA,ARIGUANI,47058,17916,17990,16628,16111,14370,4682,54919,3065,145681,580,254,346,49,1229
MAGDALENA,CERRO DE SAN ANTONIO,47161,1081,1321,855,792,422,269,2999,270,8009,117,32,18,1,168
MAGDALENA,CHIVOLO,47170,9175,13026,3502,7401,5244,798,31553,1694,72393,375,198,210,7,790
MAGDALENA,CIENAGA,47189,73,82,107,297,27,52,266,19,923,5,2,4,0,11
MAGDALENA,CONCORDIA,47205,3652,2923,2417,3474,2750,414,8747,702,25079,353,93,62,0,508
MAGDALENA,EL BANCO,47245,9623,11075,9161,10629,9228,2927,29391,1859,83893,462,156,161,29,808
MAGDALENA,EL PIÑON,47258,7866,8933,5421,7122,7636,1931,21951,1555,62415,582,222,144,8,956
MAGDALENA,EL RETEN,47268,883,912,1456,1893,1170,1932,2869,651,11766,15,14,33,4,66
MAGDALENA,FUNDACION,47288,3155,3020,2657,2955,3561,2199,9972,948,28467,32,35,60,11,138
MAGDALENA,GUAMAL,47318,8918,10724,4829,7394,4961,1308,27045,1308,66487,338,178,183,10,709
MAGDALENA,NUEVA GRANADA,47460,16430,16873,12110,14655,13517,5329,48040,3272,130226,444,201,262,47,954
MAGDALENA,PEDRAZA,47541,2989,3464,2017,1547,2862,280,8242,535,21936,261,73,55,0,389
MAGDALENA,PIJIÑO DEL CARMEN,47545,15222,15362,12166,13135,12188,5143,43396,3438,120050,531,211,227,43,1012
MAGDALENA,PIVIJAY,47551,20979,24202,16999,22821,18905,9871,65617,7940,187334,649,334,441,55,1479
MAGDALENA,PLATO,47555,17190,20517,13367,15229,16783,5902,51101,3658,143747,534,309,324,41,1208
MAGDALENA,PUEBLOVIEJO,47570,179,153,150,132,226,104,384,21,1349,2,4,4,0,10
MAGDALENA,REMOLINO,47605,2048,1880,1410,973,2247,223,6520,325,15626,198,49,36,3,286
MAGDALENA,SABANAS DE SAN ANGEL,47660,9676,10458,7673,8676,7662,3857,26651,2009,76662,455,189,159,23,826
MAGDALENA,SALAMINA,47675,3114,3375,1901,1766,1842,846,9004,487,22335,216,57,50,5,328
MAGDALENA,SAN SEBASTIAN DE BUENAVISTA,47692,5535,7243,4651,4668,5703,939,17595,1780,48114,483,137,114,8,742
MAGDALENA,SAN ZENON,47703,3773,3203,4312,3458,2638,1563,9806,533,29286,222,61,53,8,344
MAGDALENA,SANTA ANA,47707,13791,14817,10242,12731,11598,3833,42480,3730,113222,539,202,264,36,1041
MAGDALENA,SANTA BARBARA DE PINTO,47720,7243,7325,5090,7107,5797,3480,19901,1708,57651,179,96,82,26,383
MAGDALENA,SITIONUEVO,47745,883,840,479,268,691,143,2694,160,6158,127,30,12,0,169
MAGDALENA,TENERIFE,47798,6063,7686,4304,5004,4234,1020,21451,1139,50901,216,166,133,8,523
MAGDALENA,ZAPAYAN,47960,5190,6233,3368,6392,3874,1754,17172,894,44877,233,117,107,8,465
MAGDALENA,ZONA BANANERA,47980,2337,2024,2232,1815,1868,960,6925,535,18696,34,21,37,6,98
META,VILLAVICENCIO,50001,9969,10359,10949,17927,9835,17227,28629,11777,116672,818,157,253,44,1272
META,ACACIAS,50006,7389,7280,7298,11035,5750,10252,19424,5258,73686,662,126,153,23,964
META,BARRANCA DE UPIA,50110,3531,2398,2714,2271,2379,1770,8508,2003,25574,63,17,31,14,125
META,CABUYARO,50124,6576,6382,5457,6263,5036,6437,19928,5222,61301,90,33,87,36,246
META,CASTILLA LA NUEVA,50150,6522,6125,5935,5856,4768,5381,18446,3413,56446,234,86,108,24,452
META,CUBARRAL,50223,1619,1634,1686,1992,1696,2272,4801,1051,16751,171,30,46,3,250
META,CUMARAL,50226,6208,6035,6821,9714,5764,9701,16547,5410,66200,342,91,155,26,614
META,EL CALVARIO,50245,368,484,493,583,431,304,1027,168,3858,262,5,1,0,268
META,EL CASTILLO,50251,3838,3916,3532,5380,3429,5620,9663,2230,37608,325,113,90,5,533
META,EL DORADO,50270,1172,1052,959,1590,846,806,2649,551,9625,126,42,21,1,190
META,FUENTE DE ORO,50287,3125,3052,2843,3667,2264,2755,10189,2433,30328,129,53,75,10,267
META,GRANADA,50313,1920,1737,1762,1753,1446,1623,5505,1118,16864,204,31,48,2,285
META,GUAMAL,50318,2169,2296,2212,2106,2048,1979,5960,1188,19958,413,71,42,0,526
META,MAPIRIPAN,50325,17335,17255,18735,12863,19542,9762,59598,7147,162237,338,207,342,54,941
META,MESETAS,50330,10160,9675,10772,11555,9791,9940,27604,5004,94501,640,322,289,3,1254
META,LA MACARENA,50350,31399,28875,30569,26396,29292,22797,81526,7656,258510,724,582,821,41,2168
META,URIBE,50370,11716,11734,10521,10365,10383,8025,24550,3763,91057,436,271,256,16,979
META,LEJANIAS,50400,1873,2166,2232,2398,1780,1751,5360,964,18524,316,87,36,0,439
META,PUERTO CONCORDIA,50450,6580,6717,7703,6615,6797,4810,22808,3075,65105,243,127,156,20,546
META,PUERTO GAITAN,50568,19062,15670,18502,12287,17576,8698,63643,6070,161508,349,146,251,80,826
META,PUERTO LOPEZ,50573,25509,21610,22596,15389,21734,14688,79008,9689,210223,420,149,342,109,1020
META,PUERTO LLERAS,50577,13010,12952,14996,11778,13882,10356,49098,7680,133752,308,191,273,53,825
META,PUERTO RICO,50590,9571,9514,9872,8414,9125,7758,31552,5093,90899,529,214,223,24,990
META,RESTREPO,50606,3100,3237,3169,4873,2991,5133,8045,2925,33473,394,59,60,11,524
META,SAN CARLOS DE GUAROA,50680,5264,5164,3819,5310,3858,6418,13334,4817,47984,56,29,78,29,192
META,SAN JUAN DE ARAMA,50683,7911,7628,9107,10360,7524,10658,23368,6843,83399,343,117,168,40,668
META,SAN JUANITO,50686,179,199,156,255,171,169,571,101,1801,215,3,0,0,218
META,SAN MARTIN,50689,21210,20323,18424,18978,19417,16832,64919,12427,192530,426,180,367,90,1063
META,VISTAHERMOSA,50711,15044,16161,17258,16309,15964,11882,44566,7055,144239,797,359,359,40,1555
NARIÑO,PASTO,52001,4639,3198,5143,3383,5535,1483,13165,332,36878,3836,58,10,0,3904
NARIÑO,ALBAN,52019,65,79,43,92,29,152,170,23,653,78,0,0,0,78
NARIÑO,ALDANA,52022,1537,497,1451,307,879,105,4801,15,9592,581,34,4,0,619
NARIÑO,ANCUYA,52036,122,116,150,138,123,89,283,11,1032,221,0,0,0,221
NARIÑO,ARBOLEDA,52051,151,140,122,113,243,150,414,69,1402,169,3,0,0,172
NARIÑO,BARBACOAS,52079,19,69,36,80,65,62,21,21,373,22,1,0,0,23
NARIÑO,BELEN,52083,192,224,145,130,73,73,577,3,1417,248,0,0,0,248
NARIÑO,BUESACO,52110,1263,1006,1141,1206,1717,1878,3212,295,11718,1098,21,3,0,1122
NARIÑO,COLON,52203,168,188,124,181,213,85,487,28,1474,218,0,0,0,218
NARIÑO,CONSACA,52207,161,132,199,350,340,235,541,149,2107,134,2,3,0,139
NARIÑO,CONTADERO,52210,907,757,815,832,814,382,2416,35,6958,755,7,0,0,762
NARIÑO,CORDOBA,52215,831,954,683,750,1262,236,902,21,5639,887,0,0,0,887
NARIÑO,CUASPUD,52224,1525,807,1502,733,848,175,5787,18,11395,1083,18,3,0,1104
NARIÑO,CUMBAL,52227,4575,2026,4134,1013,2746,424,18852,209,33979,5765,16,1,0,5782
NARIÑO,CUMBITARA,52233,560,592,691,431,867,207,974,130,4452,209,13,3,0,225
NARIÑO,CHACHAGÜI,52240,358,299,452,342,612,299,974,155,3491,254,7,3,0,264
NARIÑO,EL CHARCO,52250,299,351,92,110,148,198,825,29,2052,197,25,3,0,225
NARIÑO,EL PEÑOL,52254,181,175,166,131,314,63,890,118,2038,110,4,3,0,117
NARIÑO,EL ROSARIO,52256,275,111,358,257,357,169,305,41,1873,138,1,0,0,139
NARIÑO,EL TABLON DE GOMEZ,52258,338,333,422,783,620,1067,984,49,4596,460,9,0,0,469
NARIÑO,EL TAMBO,52260,416,337,529,491,897,479,2013,218,5380,404,17,0,0,421
NARIÑO,FUNES,52287,294,292,584,516,890,921,665,217,4379,437,6,0,0,443
NARIÑO,GUACHUCAL,52317,4137,901,4336,662,2611,326,19461,53,32487,3796,42,9,0,3847
NARIÑO,GUAITARILLA,52320,877,662,1007,729,856,416,2828,124,7499,1239,2,0,0,1241
NARIÑO,GUALMATAN,52323,496,522,328,287,465,64,1954,11,4127,432,4,0,0,436
NARIÑO,ILES,52352,1116,1111,1363,1912,1555,1100,2461,120,10738,913,8,0,0,921
NARIÑO,IMUES,52354,371,377,545,461,687,293,1201,76,4011,811,1,0,0,812
NARIÑO,IPIALES,52356,3697,3156,3411,2407,2519,1136,10981,218,27525,2723,40,6,0,2769
NARIÑO,LA CRUZ,52378,557,699,455,526,425,576,2030,122,5390,935,1,0,0,936
NARIÑO,LA FLORIDA,52381,418,380,757,781,369,284,1719,119,4827,523,6,2,0,531
NARIÑO,LA LLANADA,52385,345,337,196,155,282,193,897,61,2466,227,0,0,0,227
NARIÑO,LA TOLA,52390,65,73,15,6,8,5,183,9,364,65,0,0,0,65
NARIÑO,LA UNION,52399,338,323,327,189,553,159,1225,133,3247,235,5,4,0,244
NARIÑO,LEIVA,52405,341,442,307,416,485,244,1200,122,3557,114,6,5,0,125
NARIÑO,LINARES,52411,103,154,173,123,179,73,487,65,1357,158,0,0,0,158
NARIÑO,LOS ANDES,52418,315,288,326,359,433,187,972,154,3034,290,3,0,0,293
NARIÑO,MAGÜI,52427,15,48,5,95,42,12,148,6,371,52,4,0,0,56
NARIÑO,MALLAMA,52435,530,482,814,1360,775,1269,1390,173,6793,607,13,1,0,621
NARIÑO,MOSQUERA,52473,25,53,15,15,8,9,90,8,223,40,0,0,0,40
NARIÑO,NARIÑO,52480,199,153,201,217,202,148,568,19,1707,154,2,1,0,157
NARIÑO,OLAYA HERRERA,52490,40,38,35,36,28,135,112,30,454,53,0,0,0,53
NARIÑO,OSPINA,52506,938,745,768,671,460,345,2588,32,6547,902,2,0,0,904
NARIÑO,FRANCISCO PIZARRO,52520,112,202,206,124,55,63,830,40,1632,135,14,0,0,149
NARIÑO,POLICARPA,52540,464,299,404,425,495,311,1018,304,3720,125,9,6,0,140
NARIÑO,POTOSI,52560,1452,1405,1192,1384,981,648,3772,55,10889,1225,4,0,0,1229
NARIÑO,PROVIDENCIA,52565,134,100,164,131,220,84,719,0,1552,309,0,0,0,309
NARIÑO,PUERRES,52573,909,1009,1049,1109,1049,473,1716,63,7377,712,12,0,0,724
NARIÑO,PUPIALES,52585,3531,1036,3064,579,3906,216,9606,34,21972,1829,38,10,0,1877
NARIÑO,RICAURTE,52612,169,161,399,565,591,598,579,102,3164,295,3,0,0,298
NARIÑO,ROBERTO PAYAN,52621,18,42,40,34,192,25,302,52,705,80,5,0,0,85
NARIÑO,SAMANIEGO,52678,596,536,585,462,560,315,1459,88,4601,689,0,0,0,689
NARIÑO,SANDONA,52683,347,371,442,872,495,354,1028,34,3943,357,4,1,0,362
NARIÑO,SAN BERNARDO,52685,402,353,213,189,541,606,1011,38,3353,400,3,0,0,403
NARIÑO,SAN LORENZO,52687,599,346,562,365,844,264,1782,327,5089,438,7,1,0,446
NARIÑO,SAN PABLO,52693,244,289,328,287,299,249,867,97,2660,530,0,0,0,530
NARIÑO,SAN PEDRO DE CARTAGO,52694,252,219,424,223,606,112,152,4,1992,265,0,0,0,265
NARIÑO,SANTA BARBARA,52696,103,115,18,36,20,14,254,75,635,103,0,0,0,103
NARIÑO,SANTACRUZ,52699,524,453,553,562,565,279,1265,45,4246,685,0,0,0,685
NARIÑO,SAPUYES,52720,1681,400,1860,440,1580,313,7028,133,13435,833,36,14,0,883
NARIÑO,TAMINANGO,52786,330,318,427,148,505,66,1106,122,3022,140,7,2,0,149
NARIÑO,TANGUA,52788,1122,740,1724,1316,1973,1214,5421,216,13726,1313,18,5,0,1336
NARIÑO,SAN ANDRES DE TUMACO,52835,689,457,783,641,619,415,1876,323,5803,335,13,6,0,354
NARIÑO,TUQUERRES,52838,3524,2189,3294,1747,2712,671,11539,94,25770,3236,19,9,0,3264
NARIÑO,YACUANQUER,52885,502,432,673,491,701,572,1891,170,5432,576,8,2,0,586
NORTE DE SANTANDER,CUCUTA,54001,4642,4699,4713,4916,4648,5775,13890,1717,45000,362,99,99,12,572
NORTE DE SANTANDER,ABREGO,54003,2287,2208,1823,1649,2058,1540,5715,754,18034,920,65,9,0,994
NORTE DE SANTANDER,ARBOLEDAS,54051,678,750,764,797,797,705,1958,218,6667,487,10,1,0,498
NORTE DE SANTANDER,BOCHALEMA,54099,590,517,571,471,609,494,1666,179,5097,284,15,4,0,303
NORTE DE SANTANDER,BUCARASICA,54109,231,255,340,317,392,271,525,57,2388,169,3,2,0,174
NORTE DE SANTANDER,CACOTA,54125,286,354,269,287,299,378,1009,204,3086,328,3,2,0,333
NORTE DE SANTANDER,CACHIRA,54128,1682,1800,1931,1667,1430,1139,4668,414,14731,787,37,8,0,832
NORTE DE SANTANDER,CHINACOTA,54172,1092,896,945,844,1024,1122,3002,266,9191,447,23,13,0,483
NORTE DE SANTANDER,CHITAGA,54174,1059,1365,763,942,857,1131,3522,826,10465,859,21,2,0,882
NORTE DE SANTANDER,CONVENCION,54206,840,673,914,881,998,753,1762,244,7065,355,20,4,0,379
NORTE DE SANTANDER,CUCUTILLA,54223,436,398,506,499,477,372,1329,191,4208,582,3,0,0,585
NORTE DE SANTANDER,DURANIA,54239,725,698,865,1129,965,989,2069,272,7712,200,23,16,0,239
NORTE DE SANTANDER,EL CARMEN,54245,1114,1043,1137,997,1349,1060,3375,406,10481,287,41,16,0,344
NORTE DE SANTANDER,EL TARRA,54250,1924,2009,1588,1846,1447,1648,4416,581,15459,250,62,30,0,342
NORTE DE SANTANDER,EL ZULIA,54261,2014,2054,2248,1932,2048,1762,5529,474,18061,270,80,40,0,390
NORTE DE SANTANDER,GRAMALOTE,54313,656,742,610,696,514,508,1893,118,5737,338,16,5,0,359
NORTE DE SANTANDER,HACARI,54344,774,775,570,795,738,830,2122,348,6952,283,20,8,0,311
NORTE DE SANTANDER,HERRAN,54347,395,743,233,328,539,367,1657,162,4424,371,4,1,0,376
NORTE DE SANTANDER,LABATECA,54377,824,815,922,933,918,1022,2461,444,8339,683,12,1,0,696
NORTE DE SANTANDER,LA ESPERANZA,54385,6806,7104,7239,9444,6824,8181,19522,3221,68341,700,114,116,25,955
NORTE DE SANTANDER,LA PLAYA,54398,594,581,433,402,545,633,1363,277,4828,271,10,3,0,284
NORTE DE SANTANDER,LOS PATIOS,54405,195,174,225,176,225,171,575,95,1836,95,7,2,0,104
NORTE DE SANTANDER,LOURDES,54418,431,443,453,592,289,488,1158,117,3971,217,12,3,0,232
NORTE DE SANTANDER,MUTISCUA,54480,595,707,429,435,485,463,1889,235,5238,511,6,3,0,520
NORTE DE SANTANDER,OCAÑA,54498,1319,1309,1221,1031,1489,850,3567,496,11282,583,33,7,0,623
NORTE DE SANTANDER,PAMPLONA,54518,715,749,698,630,707,557,2075,333,6464,687,9,1,0,697
NORTE DE SANTANDER,PAMPLONITA,54520,529,541,567,604,634,640,1649,286,5450,438,12,2,0,452
NORTE DE SANTANDER,PUERTO SANTANDER,54553,315,352,305,325,350,319,946,98,3010,11,9,7,1,28
NORTE DE SANTANDER,RAGONVALIA,54599,613,495,404,438,503,481,1492,234,4660,264,9,4,0,277
NORTE DE SANTANDER,SALAZAR,54660,1439,1279,987,1095,1448,1009,3640,302,11199,542,36,11,0,589
NORTE DE SANTANDER,SAN CALIXTO,54670,445,504,468,641,372,456,1339,201,4426,295,5,1,0,301
NORTE DE SANTANDER,SAN CAYETANO,54673,171,175,166,240,175,361,570,31,1889,44,3,4,0,51
NORTE DE SANTANDER,SANTIAGO,54680,976,778,946,1202,1207,1534,2738,309,9690,156,27,19,2,204
NORTE DE SANTANDER,SARDINATA,54720,3209,3360,2848,3265,2940,3866,8937,1126,29551,585,110,44,5,744
NORTE DE SANTANDER,SILOS,54743,811,1031,549,520,516,825,2523,303,7078,478,14,1,0,493
NORTE DE SANTANDER,TEORAMA,54800,498,516,453,649,457,516,1262,181,4532,198,15,2,0,215
NORTE DE SANTANDER,TIBU,54810,4308,4049,3818,3788,4446,3615,11329,1513,36866,634,152,62,2,850
NORTE DE SANTANDER,TOLEDO,54820,2996,2931,2826,3147,2995,3364,9312,1759,29330,1600,81,14,0,1695
NORTE DE SANTANDER,VILLA CARO,54871,1557,1663,998,1016,1295,1017,3807,391,11744,341,57,10,1,409
NORTE DE SANTANDER,VILLA DEL ROSARIO,54874,371,342,296,354,413,284,1068,116,3244,90,12,6,0,108
QUINDIO,ARMENIA,63001,599,415,607,663,897,368,1077,79,4705,153,14,7,0,174
QUINDIO,BUENAVISTA,63111,46,79,123,133,144,454,101,4,1084,24,3,4,0,31
QUINDIO,CALARCA,63130,993,715,1102,1333,1044,829,2258,110,8384,267,32,14,0,313
QUINDIO,CIRCASIA,63190,1274,718,916,579,856,444,3047,98,7932,265,35,10,0,310
QUINDIO,CORDOBA,63212,201,253,279,282,216,186,421,18,1856,86,5,5,0,96
QUINDIO,FILANDIA,63272,1120,401,1160,471,1005,308,2073,66,6604,286,24,7,0,317
QUINDIO,GENOVA,63302,487,493,528,491,628,398,898,55,3978,190,17,3,0,210
QUINDIO,LA TEBAIDA,63401,254,248,911,1310,897,1289,617,41,5567,80,12,18,0,110
QUINDIO,MONTENEGRO,63470,1036,680,1548,2009,1510,1436,2699,270,11188,190,20,32,2,244
QUINDIO,PIJAO,63548,411,492,633,1238,414,1052,864,160,5264,106,6,15,1,128
QUINDIO,QUIMBAYA,63594,1562,869,1210,1216,1624,1300,3898,472,12151,160,30,29,4,223
QUINDIO,SALENTO,63690,1337,1384,1511,1313,1120,958,3071,250,10944,203,43,23,2,271
RISARALDA,PEREIRA,66001,4642,2577,6488,3169,7189,3098,11347,749,39259,623,80,98,7,808
RISARALDA,APIA,66045,173,165,527,303,475,156,377,46,2222,156,5,1,0,162
RISARALDA,BALBOA,66075,773,520,1211,544,1607,375,1754,178,6962,117,20,15,1,153
RISARALDA,BELEN DE UMBRIA,66088,542,433,687,338,942,509,1369,93,4913,133,9,10,1,153
RISARALDA,DOSQUEBRADAS,66170,243,189,205,125,180,42,418,18,1420,178,2,0,0,180
RISARALDA,GUATICA,66318,305,301,540,310,359,214,990,68,3087,223,4,1,0,228
RISARALDA,LA CELIA,66383,167,166,220,136,274,72,280,25,1340,122,3,1,0,126
RISARALDA,LA VIRGINIA,66400,106,57,256,108,233,185,222,18,1185,24,3,4,0,31
RISARALDA,MARSELLA,66440,686,639,1602,633,1831,462,1722,68,7643,144,13,11,4,172
RISARALDA,MISTRATO,66456,770,611,1069,830,1251,746,1830,206,7313,194,22,14,0,230
RISARALDA,PUEBLO RICO,66572,459,447,744,584,698,432,1057,176,4597,280,13,3,0,296
RISARALDA,QUINCHIA,66594,331,366,703,649,869,465,946,160,4489,293,10,2,0,305
RISARALDA,SANTA ROSA DE CABAL,66682,1518,1030,1453,1004,1507,429,3724,158,10823,443,29,15,1,488
RISARALDA,SANTUARIO,66687,482,358,1193,347,1346,479,1180,73,5458,103,12,14,2,131
SANTANDER,BUCARAMANGA,68001,276,236,267,398,355,133,672,93,2430,213,6,1,0,220
SANTANDER,AGUADA,68013,328,354,338,292,369,190,969,93,2933,125,9,0,0,134
SANTANDER,ALBANIA,68020,699,850,663,566,751,620,2257,289,6695,366,20,2,0,388
SANTANDER,ARATOCA,68051,254,233,472,276,303,125,840,116,2619,202,6,2,0,210
SANTANDER,BARBOSA,68077,267,267,276,301,370,266,708,138,2593,144,6,3,0,153
SANTANDER,BARICHARA,68079,691,656,876,485,930,398,1774,359,6169,397,19,1,0,417
SANTANDER,BARRANCABERMEJA,68081,6440,6025,7451,7570,6309,6376,20172,3554,63897,475,122,116,23,736
SANTANDER,BETULIA,68092,1378,1348,1584,1542,1697,979,4399,326,13253,242,37,28,2,309
SANTANDER,BOLIVAR,68101,6061,6345,6784,11140,7186,10169,17316,5042,70043,780,116,119,26,1041
SANTANDER,CABRERA,68121,941,922,917,382,867,190,2623,194,7036,208,22,12,0,242
SANTANDER,CALIFORNIA,68132,44,62,60,57,55,82,169,33,562,52,0,0,0,52
SANTANDER,CAPITANEJO,68147,224,212,215,217,211,167,717,162,2125,270,1,0,0,271
SANTANDER,CARCASI,68152,1646,1902,1390,1509,1387,1443,5056,717,15050,872,24,4,0,900
SANTANDER,CEPITA,68160,78,74,124,133,104,79,239,72,903,126,0,0,0,126
SANTANDER,CERRITO,68162,1856,1904,1524,1589,1598,1500,4679,693,15343,839,38,3,0,880
SANTANDER,CHARALA,68167,2122,2307,2427,4677,2891,4015,6404,1901,26744,715,91,47,1,854
SANTANDER,CHARTA,68169,376,432,420,491,376,407,1060,127,3689,383,7,0,0,390
SANTANDER,CHIMA,68176,925,1002,1208,1967,1026,1125,3276,294,10823,244,49,18,0,311
SANTANDER,CHIPATA,68179,291,424,410,1013,564,1481,1084,852,6119,263,17,5,0,285
SANTANDER,CIMITARRA,68190,31936,30105,31968,45257,28007,51127,87661,16231,322292,677,299,487,166,1629
SANTANDER,CONCEPCION,68207,1660,1871,1591,1703,1469,1469,4955,624,15342,947,23,1,0,971
SANTANDER,CONFINES,68209,254,269,218,419,513,326,863,62,2924,104,12,2,0,118
SANTANDER,CONTRATACION,68211,357,430,473,649,503,627,932,345,4316,161,15,3,0,179
SANTANDER,COROMORO,68217,1447,1516,1534,2065,1950,2573,4901,1117,17103,723,44,12,0,779
SANTANDER,CURITI,68229,554,496,566,411,610,308,1724,224,4893,323,11,4,0,338
SANTANDER,EL CARMEN DE CHUCURI,68235,4471,4239,5283,4724,4297,3568,12232,1050,39864,862,130,73,3,1068
SANTANDER,EL GUACAMAYO,68245,530,605,525,1215,445,959,1445,384,6108,186,16,7,0,209
SANTANDER,EL PEÑON,68250,941,1166,1319,1145,1491,1253,3158,682,11155,408,33,10,0,451
SANTANDER,EL PLAYON,68255,778,755,1246,1001,1019,767,2076,247,7889,395,23,9,0,427
SANTANDER,ENCINO,68264,961,842,1066,1879,1018,2520,2485,1155,11926,421,41,15,0,477
SANTANDER,ENCISO,68266,546,667,539,582,544,610,1783,323,5594,444,8,0,0,452
SANTANDER,FLORIAN,68271,1011,1054,884,759,1018,761,2657,504,8648,410,20,9,0,439
SANTANDER,FLORIDABLANCA,68276,215,209,356,242,394,226,708,62,2412,128,12,1,0,141
SANTANDER,GALAN,68296,967,1116,1040,1455,1046,908,2544,303,9379,245,47,8,0,300
SANTANDER,GAMBITA,68298,1443,1626,1785,1920,1925,1788,5391,1374,17252,387,74,22,0,483
SANTANDER,GIRON,68307,830,720,1251,1074,1235,1377,2183,242,8912,272,21,16,1,310
SANTANDER,GUACA,68318,1111,1187,837,1124,1142,1500,3701,798,11400,902,8,3,0,913
SANTANDER,GUADALUPE,68320,1718,1724,2219,1599,2074,1195,5788,503,16820,357,69,27,0,453
SANTANDER,GUAPOTA,68322,1341,1032,1039,633,1117,555,3642,291,9650,143,34,26,0,203
SANTANDER,GUAVATA,68324,584,543,537,389,830,363,1950,304,5500,310,8,3,0,321
SANTANDER,GÜEPSA,68327,47,26,38,38,44,58,110,7,368,45,0,0,0,45
SANTANDER,HATO,68344,405,416,511,769,611,552,1202,106,4572,183,17,4,0,204
SANTANDER,JESUS MARIA,68368,248,349,335,339,458,433,979,206,3347,223,4,1,0,228
SANTANDER,JORDAN,68370,102,145,255,118,272,75,487,56,1510,90,5,1,0,96
SANTANDER,LA BELLEZA,68377,1480,1457,1264,1349,1447,1124,3727,689,12537,528,43,8,0,579
SANTANDER,LANDAZURI,68385,4493,3724,5483,4116,3750,2588,12093,943,37190,663,119,84,3,869
SANTANDER,LA PAZ,68397,724,946,932,1957,1288,1934,2437,755,10973,339,46,9,0,394
SANTANDER,LEBRIJA,68406,2810,2609,4450,4475,3556,3196,7674,791,29561,532,99,59,2,692
SANTANDER,LOS SANTOS,68418,483,393,835,904,786,768,1564,186,5919,307,11,9,2,329
SANTANDER,MACARAVITA,68425,744,867,692,685,726,775,2673,423,7585,429,22,0,0,451
SANTANDER,MALAGA,68432,967,892,917,785,840,760,2733,314,8208,636,13,0,0,649
SANTANDER,MATANZA,68444,516,603,706,785,633,705,1638,275,5861,405,10,2,0,417
SANTANDER,MOGOTES,68464,708,671,779,693,908,693,2129,468,7049,429,14,5,0,448
SANTANDER,MOLAGAVITA,68468,931,941,812,959,919,1101,2568,423,8654,666,9,0,0,675
SANTANDER,OCAMONTE,68498,261,292,399,616,323,400,957,186,3434,216,8,1,0,225
SANTANDER,OIBA,68500,1943,2048,1997,2274,2440,2345,6216,898,20161,434,77,43,0,554
SANTANDER,ONZAGA,68502,901,945,705,856,886,781,2343,697,8114,526,25,2,0,553
SANTANDER,PALMAR,68522,397,352,310,395,398,354,1033,68,3307,96,15,2,0,113
SANTANDER,PALMAS DEL SOCORRO,68524,877,662,689,513,706,289,2426,235,6397,114,22,12,0,148
SANTANDER,PARAMO,68533,264,293,227,348,402,414,839,125,2912,97,15,3,0,115
SANTANDER,PIEDECUESTA,68547,1792,1372,2271,2122,2186,1135,4829,412,16119,590,50,30,2,672
SANTANDER,PINCHOTE,68549,434,310,560,402,355,304,944,122,3431,96,9,6,0,111
SANTANDER,PUENTE NACIONAL,68572,1724,1674,1893,2013,2003,1325,6065,1056,17753,805,59,7,0,871
SANTANDER,PUERTO PARRA,68573,7860,7993,4991,5624,5792,4550,20506,2011,59327,190,66,84,33,373
SANTANDER,PUERTO WILCHES,68575,5861,5674,5962,5258,6568,3741,16498,1353,50915,396,163,114,7,680
SANTANDER,RIONEGRO,68615,14664,13828,15644,15865,15500,13184,39340,6216,134241,783,175,292,47,1297
SANTANDER,SABANA DE TORRES,68655,12309,11094,15793,12995,12723,12228,34120,4388,115650,557,199,308,30,1094
SANTANDER,SAN ANDRES,68669,1775,2125,1753,2198,1926,2544,5548,1044,18913,1384,26,0,0,1410
SANTANDER,SAN BENITO,68673,152,101,149,63,179,92,452,51,1239,55,5,0,0,60
SANTANDER,SAN GIL,68679,756,693,1168,914,901,741,2396,271,7840,408,23,8,0,439
SANTANDER,SAN JOAQUIN,68682,312,346,192,239,395,279,840,217,2820,238,2,1,0,241
SANTANDER,SAN JOSE DE MIRANDA,68684,627,666,595,643,571,550,1920,426,5998,636,5,1,0,642
SANTANDER,SAN MIGUEL,68686,450,496,332,399,407,333,1495,246,4158,322,4,1,0,327
SANTANDER,SAN VICENTE DE CHUCURI,68689,6084,5728,7683,6050,6152,4544,17450,1465,55156,1096,175,118,7,1396
SANTANDER,SANTA BARBARA,68705,156,222,257,265,228,187,391,76,1782,219,4,0,0,223
SANTANDER,SANTA HELENA DEL OPON,68720,2141,2644,2517,4339,1829,2257,6670,495,22892,414,92,42,0,548
SANTANDER,SIMACOTA,68745,7468,7617,8404,8524,8160,6521,20355,1843,68892,634,174,170,14,992
SANTANDER,SOCORRO,68755,1225,1075,888,981,1054,790,3450,265,9728,226,32,18,0,276
SANTANDER,SUAITA,68770,1651,1406,1742,1955,1950,2665,5184,1169,17722,351,72,36,0,459
SANTANDER,SUCRE,68773,1394,1595,1518,1604,1843,1309,4918,698,14879,710,27,8,1,746
SANTANDER,SURATA,68780,805,855,808,850,919,881,2453,390,7961,467,22,6,0,495
SANTANDER,TONA,68820,870,1023,886,926,862,650,2605,172,7994,596,17,2,0,615
SANTANDER,VALLE DE SAN JOSE,68855,208,257,267,332,288,377,796,216,2741,182,3,2,0,187
SANTANDER,VELEZ,68861,3233,3243,3471,3995,3709,4177,8998,1603,32429,924,111,51,0,1086
SANTANDER,VETAS,68867,87,107,97,144,87,90,215,25,852,108,0,0,0,108
SANTANDER,VILLANUEVA,68872,455,465,1003,413,810,279,1395,233,5053,315,9,2,0,326
SANTANDER,ZAPATOCA,68895,1119,936,1160,681,1291,361,3266,227,9041,211,31,19,0,261
SUCRE,SINCELEJO,70001,3935,4498,4051,6382,3731,2346,12927,1521,39391,491,94,85,8,678
SUCRE,BUENAVISTA,70110,4981,4528,3711,3866,3569,683,15588,836,37762,231,72,86,10,399
SUCRE,CAIMITO,70124,3425,3003,2924,3669,4626,2114,9391,1990,31142,211,43,32,12,298
SUCRE,COLOSO,70204,885,912,525,444,1126,58,2786,174,6910,185,19,12,1,217
SUCRE,COROZAL,70215,7042,8342,5327,5233,6125,1243,23867,1259,58438,409,103,119,19,650
SUCRE,COVEÑAS,70221,514,438,273,476,505,367,1315,70,3958,89,11,8,0,108
SUCRE,CHALAN,70230,658,718,317,141,311,53,1534,113,3845,211,3,5,0,219
SUCRE,EL ROBLE,70233,2827,2694,1919,860,3842,68,8196,502,20908,266,66,47,2,381
SUCRE,GALERAS,70235,9334,9192,6387,3680,8152,999,28667,1261,67672,495,153,168,18,834
SUCRE,GUARANDA,70265,4782,4408,4168,2530,5660,324,14853,834,37559,477,135,84,2,698
SUCRE,LA UNION,70400,3460,3137,2623,1942,3829,1038,12447,766,29242,290,57,68,6,421
SUCRE,LOS PALMITOS,70418,5686,6129,4121,3409,4734,707,18892,1030,44708,489,71,87,13,660
SUCRE,MAJAGUAL,70429,10972,10554,9346,10131,11708,3684,34337,2837,93569,1049,261,189,17,1516
SUCRE,MORROA,70473,2092,2222,1531,1930,1575,717,6445,490,17002,235,51,39,2,327
SUCRE,OVEJAS,70508,4443,4751,3684,2100,4717,520,13469,756,34440,642,86,58,5,791
SUCRE,PALMITO,70523,2844,3009,2631,3653,2371,2740,9033,831,27112,229,20,44,12,305
SUCRE,SAMPUES,70670,4624,4711,4072,3158,3210,1071,14547,773,36166,478,89,85,6,658
SUCRE,SAN BENITO ABAD,70678,5368,5083,4570,2940,6143,775,18101,1206,44186,284,112,114,9,519
SUCRE,SAN JUAN DE BETULIA,70702,6161,7466,4118,3464,4952,843,19463,1132,47599,354,70,87,19,530
SUCRE,SAN MARCOS,70708,9040,8510,8475,10269,7152,5593,32127,3753,84919,657,158,178,25,1018
SUCRE,SAN ONOFRE,70713,9292,9043,8876,15824,10747,8909,26380,2731,91802,749,185,168,30,1132
SUCRE,SAN PEDRO,70717,6733,7807,5099,5433,5749,1249,19925,989,52984,375,83,126,14,598
SUCRE,SAN LUIS DE SINCE,70742,15816,15995,12441,8054,15418,1990,45326,2646,117686,677,189,259,44,1169
SUCRE,SUCRE,70771,4129,4124,3841,3562,5430,495,15130,821,37532,470,121,78,5,674
SUCRE,SANTIAGO DE TOLU,70820,3963,4023,3038,10372,3487,10399,11040,1571,47893,208,33,62,29,332
SUCRE,TOLU VIEJO,70823,3194,3523,3991,11079,3695,8149,9027,985,43643,412,64,61,14,551
TOLIMA,IBAGUE,73001,4304,4277,4023,3885,3686,2356,11732,714,34977,1109,92,49,6,1256
TOLIMA,ALPUJARRA,73024,1501,1750,1763,1595,1784,1328,4772,579,15072,393,56,24,0,473
TOLIMA,ALVARADO,73026,1892,1721,2096,1313,1862,777,5926,345,15932,294,40,19,5,358
TOLIMA,AMBALEMA,73030,1512,1346,968,520,1020,463,4768,314,10911,81,14,23,3,121
TOLIMA,ANZOATEGUI,73043,953,1047,1449,1484,1473,918,2289,254,9867,441,30,9,0,480
TOLIMA,ARMERO GUAYABAL,73055,3309,3109,3219,3515,3107,1672,9088,1074,28093,212,47,62,10,331
TOLIMA,ATACO,73067,2301,2451,2830,3173,2820,2377,8193,1627,25772,668,95,28,2,793
TOLIMA,CAJAMARCA,73124,2076,2231,2611,2998,1781,1402,5083,663,18845,440,59,48,0,547
TOLIMA,CARMEN DE APICALA,73148,1019,797,808,927,929,589,2956,304,8329,188,34,14,0,236
TOLIMA,CASABIANCA,73152,502,507,725,588,492,381,1237,189,4621,201,12,6,0,219
TOLIMA,CHAPARRAL,73168,4435,5067,4769,7010,5048,5124,12496,2415,46364,1280,163,68,5,1516
TOLIMA,COELLO,73200,1815,1726,1574,1009,1531,821,4700,268,13444,233,32,26,4,295
TOLIMA,COYAIMA,73217,3081,3477,2719,1379,3311,617,9754,645,24983,437,93,51,2,583
TOLIMA,CUNDAY,73226,2298,2476,2873,3249,2437,3289,7538,2290,26450,577,86,60,1,724
TOLIMA,DOLORES,73236,2504,3406,3032,4558,3529,3249,9353,1933,31564,666,112,53,2,833
TOLIMA,ESPINAL,73268,658,461,521,377,577,200,1616,95,4505,235,16,5,0,256
TOLIMA,FALAN,73270,579,514,925,1261,754,557,1568,286,6444,275,14,5,1,295
TOLIMA,FLANDES,73275,868,659,999,1315,654,335,1593,96,6519,107,15,15,1,138
TOLIMA,FRESNO,73283,552,622,782,916,552,450,1260,104,5238,311,13,4,0,328
TOLIMA,GUAMO,73319,4016,4461,4815,2974,4129,1320,13203,887,35805,725,116,72,4,917
TOLIMA,HERVEO,73347,1186,1108,1412,1137,1040,597,2422,228,9130,270,35,16,0,321
TOLIMA,HONDA,73349,2235,1615,1803,1339,1491,1041,5017,375,14916,72,25,23,6,126
TOLIMA,ICONONZO,73352,1168,1196,1738,2204,1243,1573,3531,807,13460,691,42,12,0,745
TOLIMA,LERIDA,73408,1726,1594,1837,1097,1536,762,4992,345,13889,255,42,33,1,331
TOLIMA,LIBANO,73411,691,655,949,935,820,733,2001,94,6878,414,16,5,0,435
TOLIMA,SAN SEBASTIAN DE MARIQUITA,73443,1612,1387,2472,1518,1853,1339,3989,386,14556,267,37,36,2,342
TOLIMA,MELGAR,73449,710,641,456,875,592,699,1799,517,6289,196,11,10,1,218
TOLIMA,MURILLO,73461,2722,2731,2388,2101,1979,1180,6604,488,20193,411,104,27,0,542
TOLIMA,NATAGAIMA,73483,3703,4016,3795,1474,3774,669,11234,674,29339,331,133,67,1,532
TOLIMA,ORTEGA,73504,3630,4046,4764,4873,4209,4102,11673,1990,39287,1118,125,68,0,1311
TOLIMA,PALOCABILDO,73520,171,136,173,119,107,98,404,14,1222,175,1,0,0,176
TOLIMA,PIEDRAS,73547,3411,3010,2940,1361,2539,769,10618,569,25217,177,45,63,7,292
TOLIMA,PLANADAS,73555,1929,1997,2416,2794,2473,1804,5265,605,19283,405,94,30,0,529
TOLIMA,PRADO,73563,3019,3238,2590,2805,2527,2633,8286,1033,26131,396,75,62,3,536
TOLIMA,PURIFICACION,73585,2866,2708,2682,2085,2943,1273,8427,946,23930,633,83,36,1,753
TOLIMA,RIOBLANCO,73616,1458,1370,1657,1892,1171,942,3362,360,12212,575,25,10,0,610
TOLIMA,RONCESVALLES,73622,3533,3715,3871,2773,3920,2058,8670,965,29505,437,112,58,3,610
TOLIMA,ROVIRA,73624,1629,1396,1803,1023,1370,770,3466,303,11760,399,40,12,0,451
TOLIMA,SALDAÑA,73671,1788,2058,1602,958,1577,600,5350,528,14461,192,31,37,2,262
TOLIMA,SAN ANTONIO,73675,982,1108,1164,1377,887,1308,2581,309,9716,422,24,11,0,457
TOLIMA,SAN LUIS,73678,2821,2809,3643,3092,3395,1475,8887,662,26784,724,77,54,0,855
TOLIMA,SANTA ISABEL,73686,1341,1354,1560,1216,1373,742,3599,338,11523,382,41,12,0,435
TOLIMA,SUAREZ,73770,1732,1545,1610,1000,1413,528,5026,422,13276,186,32,33,3,254
TOLIMA,VALLE DE SAN JUAN,73854,1226,1214,1290,781,1356,562,3186,353,9968,214,40,16,0,270
TOLIMA,VENADILLO,73861,1616,1574,2017,1876,1768,1121,5525,360,15857,318,28,27,5,378
TOLIMA,VILLAHERMOSA,73870,1122,1007,1433,1357,970,623,2711,86,9309,348,37,12,0,397
TOLIMA,VILLARRICA,73873,628,560,823,927,626,638,1689,319,6210,423,12,1,0,436
VALLE DEL CAUCA,CALI,76001,663,603,609,701,557,278,2189,98,5698,228,9,11,0,248
VALLE DEL CAUCA,ALCALA,76020,1013,374,1253,283,1272,394,1870,95,6554,109,22,18,0,149
VALLE DEL CAUCA,ANDALUCIA,76036,630,555,586,818,696,475,1254,92,5106,96,12,11,1,120
VALLE DEL CAUCA,ANSERMANUEVO,76041,2312,1430,4793,1804,3844,979,5239,343,20744,214,28,57,2,301
VALLE DEL CAUCA,ARGELIA,76054,435,298,1493,390,808,129,995,87,4635,134,11,5,1,151
VALLE DEL CAUCA,BOLIVAR,76100,1559,1446,2300,2187,2554,1451,4202,912,16611,312,52,37,1,402
VALLE DEL CAUCA,BUENAVENTURA,76109,30,21,86,74,101,36,125,10,483,27,2,0,0,29
VALLE DEL CAUCA,GUADALAJARA DE BUGA,76111,2725,2468,3583,3669,3717,2181,7023,907,26273,390,64,63,1,518
VALLE DEL CAUCA,BUGALAGRANDE,76113,2789,2832,3082,3454,3433,2194,6523,1221,25528,212,32,34,16,294
VALLE DEL CAUCA,CAICEDONIA,76122,260,288,790,816,731,481,780,133,4279,134,12,10,0,156
VALLE DEL CAUCA,CALIMA,76126,1108,708,1181,1188,513,397,3498,129,8722,152,19,23,1,195
VALLE DEL CAUCA,CANDELARIA,76130,277,388,394,897,152,627,661,102,3498,94,10,4,1,109
VALLE DEL CAUCA,CARTAGO,76147,2635,1669,4927,2515,4167,1834,6345,736,24828,159,49,56,9,273
VALLE DEL CAUCA,DAGUA,76233,986,890,1822,1560,1268,1235,3276,340,11377,474,25,16,0,515
VALLE DEL CAUCA,EL AGUILA,76243,382,435,870,596,944,333,1330,103,4993,180,16,7,0,203
VALLE DEL CAUCA,EL CAIRO,76246,819,738,1610,832,848,345,1469,191,6852,232,12,17,1,262
VALLE DEL CAUCA,EL CERRITO,76248,1346,859,1199,1056,1237,1096,3279,432,10504,132,36,24,2,194
VALLE DEL CAUCA,EL DOVIO,76250,1436,1495,2848,2662,1815,1788,4562,969,17575,336,41,40,2,419
VALLE DEL CAUCA,FLORIDA,76275,445,475,642,882,771,383,1246,292,5136,163,11,7,0,181
VALLE DEL CAUCA,GINEBRA,76306,557,603,619,1029,687,871,1623,136,6125,187,18,9,1,215
VALLE DEL CAUCA,GUACARI,76318,381,220,389,612,361,269,1125,93,3450,105,11,9,0,125
VALLE DEL CAUCA,JAMUNDI,76364,884,959,1009,1585,917,827,2681,364,9226,261,25,17,1,304
VALLE DEL CAUCA,LA CUMBRE,76377,598,316,942,622,1036,489,1537,179,5719,200,17,10,0,227
VALLE DEL CAUCA,LA UNION,76400,783,688,1197,612,1341,477,1966,340,7404,170,28,15,0,213
VALLE DEL CAUCA,LA VICTORIA,76403,1536,1600,2384,5432,2342,6108,4886,1611,25899,186,33,56,7,282
VALLE DEL CAUCA,OBANDO,76497,1365,1047,2403,1807,2472,1445,3095,565,14199,190,28,28,5,251
VALLE DEL CAUCA,PALMIRA,76520,2462,2093,2277,2523,2727,1544,6010,600,20236,395,63,43,1,502
VALLE DEL CAUCA,PRADERA,76563,798,875,1406,951,1160,459,2579,225,8453,214,20,11,1,246
VALLE DEL CAUCA,RESTREPO,76606,1227,694,1784,1187,1710,781,3553,304,11240,174,32,28,1,235
VALLE DEL CAUCA,RIOFRIO,76616,870,833,1469,1187,1017,1093,3209,526,10204,194,21,17,2,234
VALLE DEL CAUCA,ROLDANILLO,76622,1126,857,2491,741,1859,434,2696,232,10436,213,23,19,2,257
VALLE DEL CAUCA,SAN PEDRO,76670,1181,964,1530,2005,1395,1331,2651,793,11850,245,27,23,2,297
VALLE DEL CAUCA,SEVILLA,76736,1780,1878,2630,2930,2265,2179,4824,585,19071,286,37,37,4,364
VALLE DEL CAUCA,TORO,76823,1377,1008,2695,998,2813,429,3447,222,12989,180,17,28,5,230
VALLE DEL CAUCA,TRUJILLO,76828,676,724,1129,675,784,326,2130,150,6594,237,22,12,0,271
VALLE DEL CAUCA,TULUA,76834,4627,4316,5476,4943,4956,3880,10822,900,39920,697,94,94,6,891
VALLE DEL CAUCA,ULLOA,76845,602,213,727,372,722,408,1668,181,4893,92,9,9,2,112
VALLE DEL CAUCA,VERSALLES,76863,1579,1159,3408,1480,2927,1064,4549,896,17062,234,42,33,4,313
VALLE DEL CAUCA,VIJES,76869,747,662,720,438,590,487,1655,83,5382,121,12,13,0,146
VALLE DEL CAUCA,YOTOCO,76890,1757,1104,2120,1220,2133,906,5178,243,14661,184,26,24,7,241
VALLE DEL CAUCA,YUMBO,76892,309,206,501,419,265,219,780,118,2817,72,12,6,0,90
VALLE DEL CAUCA,ZARZAL,76895,2292,1775,2892,3613,3281,3702,6622,2263,26440,149,27,43,11,230
ARAUCA,ARAUCA,81001,37461,38440,28297,22988,28177,13222,120690,10910,300185,562,244,492,154,1452
ARAUCA,ARAUQUITA,81065,31249,34034,23739,24747,21418,22617,76543,10497,244844,1322,697,716,43,2778
ARAUCA,CRAVO NORTE,81220,9735,9672,7995,5518,7848,2820,32176,1711,77475,110,76,133,44,363
ARAUCA,FORTUL,81300,13789,14287,9998,10091,9115,10212,34179,3570,105241,872,418,298,3,1591
ARAUCA,PUERTO RONDON,81591,16434,15613,14146,14409,14367,10922,53339,7535,146765,111,46,153,96,406
ARAUCA,SARAVENA,81736,11805,11903,9724,8618,8202,7430,29519,3164,90365,1177,385,238,0,1800
ARAUCA,TAME,81794,34045,33988,27337,40063,26997,42757,94783,24272,324242,1635,741,777,85,3238
CASANARE,YOPAL,85001,24887,23110,20436,21382,20439,19999,75542,15331,221126,1415,376,359,87,2237
CASANARE,AGUAZUL,85010,12593,11771,10991,12836,10778,12329,34977,6723,112998,818,259,246,33,1356
CASANARE,CHAMEZA,85015,1185,1049,1139,1079,1159,1133,3232,724,10700,292,49,4,0,345
CASANARE,HATO COROZAL,85125,37586,35439,32890,32455,29594,32211,122158,33364,355697,689,281,474,179,1623
CASANARE,LA SALINA,85136,117,97,157,117,109,89,358,142,1186,88,1,0,0,89
CASANARE,MANI,85139,20076,17696,17621,14724,16722,11647,59020,6717,164223,388,181,242,82,893
CASANARE,MONTERREY,85162,4219,3923,3374,4111,3701,5227,12385,3602,40542,344,80,73,14,511
CASANARE,NUNCHIA,85225,7625,6963,6988,8346,6640,8877,21032,6671,73142,793,187,173,15,1168
CASANARE,OROCUE,85230,15124,14360,14209,9652,15933,6732,54356,6666,137032,247,104,217,57,625
CASANARE,PAZ DE ARIPORO,85250,54128,49224,48187,41754,47591,34700,194009,26413,496006,1016,388,789,233,2426
CASANARE,PORE,85263,7596,6292,5921,6965,5524,6806,20624,5438,65166,424,151,133,22,730
CASANARE,RECETOR,85279,937,816,929,1074,841,1389,2428,554,8968,200,48,10,0,258
CASANARE,SABANALARGA,85300,2017,1782,1865,2254,1673,2464,5967,1593,19615,193,54,43,3,293
CASANARE,SACAMA,85315,309,314,293,399,310,350,1007,359,3341,83,14,5,0,102
CASANARE,SAN LUIS DE PALENQUE,85325,21540,18722,17252,17095,15822,14423,70285,11839,186978,464,174,285,76,999
CASANARE,TAMARA,85400,2439,2499,2340,3574,1950,3776,7780,2598,26956,607,106,50,1,764
CASANARE,TAURAMENA,85410,15667,13860,13418,15288,12966,15830,45977,10940,143946,678,194,206,61,1139
CASANARE,TRINIDAD,85430,19106,16203,15858,17034,15544,15646,58849,10035,168275,385,140,224,84,833
CASANARE,VILLANUEVA,85440,4284,4552,3732,6972,3345,6874,13812,4519,48090,279,61,77,23,440
PUTUMAYO,MOCOA,86001,438,452,652,937,550,763,1434,208,5434,357,10,0,0,367
PUTUMAYO,COLON,86219,382,304,404,278,374,143,1167,16,3068,217,6,1,0,224
PUTUMAYO,ORITO,86320,1141,972,1728,1474,1528,1204,4000,642,12689,787,24,7,0,818
PUTUMAYO,PUERTO ASIS,86568,3393,3238,3999,3454,3995,2545,11336,1073,33033,1103,102,40,1,1246
PUTUMAYO,PUERTO CAICEDO,86569,1224,1139,1330,1398,1563,1288,4294,1304,13540,476,48,15,0,539
PUTUMAYO,PUERTO GUZMAN,86571,11704,12228,11676,14432,13154,14180,36166,3848,117388,976,491,323,6,1796
PUTUMAYO,PUERTO LEGUIZAMO,86573,6964,6085,6101,5093,6508,4747,21147,2675,59320,326,131,140,17,614
PUTUMAYO,SIBUNDOY,86749,388,381,482,266,331,106,1122,17,3093,256,6,1,0,263
PUTUMAYO,SAN FRANCISCO,86755,703,725,797,723,716,351,1862,44,5921,453,7,1,0,461
PUTUMAYO,SAN MIGUEL,86757,740,622,626,1078,666,753,1913,358,6756,328,15,6,0,349
PUTUMAYO,SANTIAGO,86760,531,447,515,345,413,107,1370,15,3743,382,0,1,0,383
PUTUMAYO,VALLE DEL GUAMUEZ,86865,2146,1987,2014,2418,2008,1878,6679,568,19698,837,61,18,0,916
PUTUMAYO,VILLAGARZON,86885,951,872,1259,1573,1505,1782,3703,432,12077,467,30,19,0,516
SAN ANDRES Y PROVIDENCIA,SAN ANDRES,88001,85,41,30,9,33,24,64,7,293,27,0,0,0,27
SAN ANDRES Y PROVIDENCIA,PROVIDENCIA,88564,103,20,12,14,6,11,66,8,240,16,1,0,0,17
AMAZONAS,LETICIA,91001,40,41,28,36,49,28,173,29,424,46,0,0,0,46
AMAZONAS,EL ENCANTO,91263,1,3,2,0,5,1,9,2,23,3,0,0,0,3
AMAZONAS,LA CHORRERA,91405,0,0,0,0,0,0,0,0,0,0,0,0,0,0
AMAZONAS,LA PEDRERA,91407,12,7,15,5,5,21,22,5,92,10,0,0,0,10
AMAZONAS,LA VICTORIA,91430,0,0,0,0,0,0,0,0,0,0,0,0,0,0
AMAZONAS,MIRITI PARANA,91460,0,0,0,0,0,0,0,0,0,0,0,0,0,0
AMAZONAS,PUERTO ALEGRIA,91530,10,13,15,6,12,6,55,11,128,15,0,0,0,15
AMAZONAS,PUERTO ARICA,91536,0,0,0,0,0,0,0,0,0,0,0,0,0,0
AMAZONAS,PUERTO NARIÑO,91540,11,12,8,9,10,5,19,5,79,14,0,0,0,14
AMAZONAS,PUERTO SANTANDER,91669,0,0,0,0,0,0,0,0,0,0,0,0,0,0
AMAZONAS,TARAPACA,91798,7,9,14,10,30,40,45,9,164,7,0,0,0,7
GUAINIA,INIRIDA,94001,218,228,205,331,155,817,728,180,2862,35,7,8,0,50
GUAINIA,BARRANCO MINAS,94343,379,344,175,181,252,233,954,161,2679,28,7,5,1,41
GUAINIA,SAN FELIPE,94883,0,0,0,0,0,0,0,0,0,0,0,0,0,0
GUAINIA,PUERTO COLOMBIA,94884,0,0,0,0,0,0,0,0,0,0,0,0,0,0
GUAINIA,LA GUADALUPE,94885,0,0,0,0,0,0,0,0,0,0,0,0,0,0
GUAINIA,CACAHUAL,94886,0,0,0,0,0,0,0,0,0,0,0,0,0,0
GUAINIA,PANA PANA,94887,0,0,0,0,0,0,0,0,0,0,0,0,0,0
GUAINIA,MORICHAL,94888,0,0,0,0,0,0,0,0,0,0,0,0,0,0
GUAVIARE,SAN JOSE DEL GUAVIARE,95001,29071,28631,28177,25351,22259,18178,74987,8212,234866,1409,631,576,46,2662
GUAVIARE,CALAMAR,95015,11711,12353,10268,12766,10022,11742,29344,4414,102620,272,188,240,35,735
GUAVIARE,EL RETORNO,95025,23862,22482,20832,19311,17320,17407,59179,7701,188094,724,472,557,35,1788
GUAVIARE,MIRAFLORES,95200,3293,3461,2359,2089,2308,1757,7775,624,23666,115,62,65,4,246
VAUPES,MITU,97001,62,64,67,50,48,39,245,41,616,47,1,0,0,48
VAUPES,CARURU,97161,91,62,40,49,74,37,211,41,605,22,3,1,0,26
VAUPES,PACOA,97511,0,0,0,0,0,0,0,0,0,0,0,0,0,0
VAUPES,TARAIRA,97666,0,0,0,0,0,0,0,0,0,0,0,0,0,0
VAUPES,PAPUNAHUA,97777,0,0,0,0,0,0,0,0,0,0,0,0,0,0
VAUPES,YAVARATE,97889,0,0,0,0,0,0,0,0,0,0,0,0,0,0
VICHADA,PUERTO CARREÑO,99001,1943,1899,1814,1717,2389,678,7622,601,18663,118,42,36,6,202
VICHADA,LA PRIMAVERA,99524,16249,13984,12823,10643,13676,6034,56465,4757,134631,241,111,225,67,644
VICHADA,SANTA ROSALIA,99624,4679,4310,4173,1862,3878,2634,18104,816,40456,54,23,70,22,169
VICHADA,CUMARIBO,99773,7282,6576,6032,4311,6673,3194,24851,1972,60891,465,119,140,15,739
,,,,,,,,,,,,,,,,
,,,,,,,,,,,,,,,,
,,,,,,,,,,,,,,,,
,,,,,,,,,,,,,,,,
